"player","g","gs","mp","fg","fga","x3p","x3pa","x2p","x2pa","ft","fta","orb","drb","trb","ast","stl","blk","tov","pf","pts","mpg","fg_percent","x3p_percent","x2p_percent","ft_percent","pts_per_game","hof","pos","years"
"Aaron Gray",387,93,4517,509,1007,0,4,509,1003,217,379,518,889,1407,251,113,106,314,796,1235,11.671834625323,0.505461767626614,0,0.507477567298106,0.572559366754617,3.19121447028424,FALSE,3,7
"Aaron Williams",838,88,13669,1777,3577,1,17,1776,3560,1063,1442,1159,2015,3174,525,320,597,742,2030,4618,16.3114558472554,0.496785015376013,0.0588235294117647,0.498876404494382,0.737170596393897,5.51073985680191,FALSE,3,14
"Acie Earl",240,18,3012,428,1076,0,14,428,1062,312,471,225,388,613,81,78,154,205,412,1168,12.55,0.397769516728625,0,0.4030131826742,0.662420382165605,4.86666666666667,FALSE,3,4
"Adam Keefe",617,98,10334,1120,2230,1,14,1119,2216,866,1213,999,1557,2556,427,307,173,545,1114,3107,16.7487844408428,0.502242152466368,0.0714285714285714,0.504963898916967,0.713932399010717,5.03565640194489,FALSE,3,9
"Adonal Foyle",743,269,13122,1325,2777,0,2,1325,2775,356,713,1310,2177,3487,345,264,1201,600,1580,3006,17.6608344549125,0.477133597407274,0,0.477477477477477,0.49929873772791,4.04576043068641,FALSE,3,12
"Al Harrington",1132,579,33118,6055,13613,1275,3541,4780,10072,2606,3567,1745,4688,6433,1900,1011,292,2168,3565,15991,29.256183745583,0.444795416146331,0.360067777463993,0.474583002382844,0.730585926548921,14.1263250883392,FALSE,3,16
"Alan Henderson",652,220,13780,1976,4215,5,26,1971,4189,1137,1778,1426,1823,3249,397,364,297,717,1436,5094,21.1349693251534,0.468801897983393,0.192307692307692,0.470518023394605,0.639482564679415,7.81288343558282,FALSE,3,12
"Alec Kessler",210,24,2937,425,998,10,24,415,974,224,301,258,493,751,81,39,71,192,451,1084,13.9857142857143,0.425851703406814,0.416666666666667,0.426078028747433,0.744186046511628,5.16190476190476,FALSE,3,4
"Alexander Volkov",149,31,2453,388,853,48,144,340,709,195,318,155,229,384,333,102,52,154,344,1019,16.4630872483221,0.454865181711606,0.333333333333333,0.479548660084626,0.613207547169811,6.83892617449664,FALSE,3,2
"Alexis Ajinça",327,78,4245,704,1416,24,76,680,1340,264,333,363,865,1228,153,113,200,267,734,1696,12.9816513761468,0.497175141242938,0.31578947368421,0.507462686567164,0.792792792792793,5.18654434250764,FALSE,3,7
"Alonzo Mourning",875,703,26677,5216,9913,22,89,5194,9824,4139,6003,2237,5098,7335,964,422,2430,2266,2892,14593,30.488,0.526177746393625,0.247191011235955,0.528705211726384,0.689488589038814,16.6777142857143,TRUE,3,15
"Alton Lister",1017,601,19700,2565,5012,1,9,2564,5003,1310,2190,1911,4365,6276,933,357,1515,1498,3315,6441,19.3706981317601,0.511771747805267,0.111111111111111,0.512492504497302,0.598173515981735,6.33333333333333,FALSE,3,16
"Amal McCaskill",114,4,968,81,215,0,3,81,212,42,69,75,138,213,36,24,36,52,132,204,8.49122807017544,0.376744186046512,0,0.382075471698113,0.608695652173913,1.78947368421053,FALSE,3,4
"Amar'e Stoudemire",905,711,27499,6184,11499,30,131,6154,11368,4276,5630,2139,4822,6961,1095,665,1092,2031,2846,16674,30.385635359116,0.537785894425602,0.229007633587786,0.541344123856439,0.759502664298401,18.4243093922652,FALSE,3,14
"Andray Blatche",564,191,12462,2327,4981,52,219,2275,4762,1000,1380,1043,1981,3024,798,492,458,914,1382,5706,22.0957446808511,0.467175266010841,0.237442922374429,0.477740445191096,0.72463768115942,10.1170212765957,FALSE,3,9
"Andrea Bargnani",550,377,15806,2932,6676,627,1771,2305,4905,1382,1677,530,2011,2541,653,207,470,851,1338,7873,28.7381818181818,0.439185140802876,0.354037267080745,0.469928644240571,0.824090638044126,14.3145454545455,FALSE,3,10
"Andrew Bynum",444,338,11206,2011,3671,1,9,2010,3662,1024,1480,1060,2306,3366,519,139,686,678,1059,5047,25.2387387387387,0.547807137019886,0.111111111111111,0.548880393227744,0.691891891891892,11.3671171171171,FALSE,3,8
"Andrew DeClercq",634,285,10949,1256,2483,0,2,1256,2481,674,1073,1129,1614,2743,370,440,330,604,1950,3186,17.2697160883281,0.505839710028192,0,0.506247480854494,0.628145386766076,5.02523659305994,FALSE,3,10
"Andrew Lang",808,449,17709,2133,4575,6,25,2127,4550,991,1320,1341,2625,3966,489,374,1225,821,2278,5263,21.9170792079208,0.466229508196721,0.24,0.467472527472527,0.750757575757576,6.51361386138614,FALSE,3,12
"Andris Biedriņš",516,311,11146,1432,2409,0,2,1432,2407,383,766,1190,2441,3631,467,331,580,479,1626,3247,21.6007751937984,0.594437525944375,0,0.594931449937682,0.5,6.29263565891473,FALSE,3,10
"Anthony Mason",882,559,30605,3583,7033,2,12,3581,7021,2488,3511,1912,5367,7279,2963,648,244,1549,2353,9656,34.6995464852608,0.509455424427698,0.166666666666667,0.510041304657456,0.70863001993734,10.9478458049887,FALSE,3,13
"Anthony Randolph",292,46,4431,800,1758,21,87,779,1671,473,647,378,860,1238,220,172,248,351,518,2094,15.1746575342466,0.455062571103527,0.241379310344828,0.466187911430281,0.731066460587326,7.17123287671233,FALSE,3,6
"Antoine Carr",1064,172,21507,4019,8007,6,53,4013,7954,2081,2662,1266,2440,3706,1205,391,993,1312,3310,10125,20.2133458646617,0.501935806169602,0.113207547169811,0.50452602464169,0.781743050338092,9.51597744360902,FALSE,3,16
"Antonio Davis",1027,642,29594,3535,7970,2,24,3533,7946,2893,3979,2620,5014,7634,1175,490,964,1511,2882,9965,28.8159688412853,0.443538268506901,0.0833333333333333,0.444626227032469,0.727067102287007,9.70301850048686,FALSE,3,13
"Antonio McDyess",1057,665,28980,5172,10429,7,60,5165,10369,2166,3247,2548,5347,7895,1336,819,1126,1680,3194,12517,27.4172185430464,0.495924825007191,0.116666666666667,0.498119394348539,0.667077302125038,11.8420056764428,FALSE,3,15
"Arvydas Sabonis",470,314,11375,2082,4160,136,415,1946,3745,1329,1690,734,2702,3436,964,370,494,837,1290,5629,24.2021276595745,0.500480769230769,0.327710843373494,0.519626168224299,0.786390532544379,11.9765957446809,TRUE,3,7
"Audie Norris",187,14,2585,283,554,0,3,283,551,253,382,197,379,576,147,85,69,247,513,819,13.8235294117647,0.510830324909747,0,0.513611615245009,0.662303664921466,4.37967914438503,FALSE,3,3
"Ben Coleman",297,66,5110,809,1582,0,8,809,1574,469,617,421,857,1278,190,137,140,429,843,2087,17.2053872053872,0.511378002528445,0,0.513977128335451,0.760129659643436,7.02693602693603,FALSE,3,5
"Ben Wallace",1160,984,34290,2707,5773,7,55,2700,5718,1181,2848,3678,7408,11086,1542,1457,2254,1128,2199,6602,29.5603448275862,0.468906980772562,0.127272727272727,0.472193074501574,0.414676966292135,5.69137931034483,TRUE,3,16
"Benoit Benjamin",1019,756,26797,4401,8863,1,24,4400,8839,2465,3430,1808,5726,7534,1275,652,1859,2304,2834,11268,26.297350343474,0.496558727293242,0.0416666666666667,0.497793868084625,0.71865889212828,11.0578999018646,FALSE,3,15
"Bill Garnett",300,62,5260,572,1167,0,9,572,1158,494,686,468,830,1298,393,159,173,332,832,1638,17.5333333333333,0.490145672664953,0,0.493955094991364,0.720116618075802,5.46,FALSE,3,4
"Bill Laimbeer",1148,NA,35785,5839,11734,206,632,5633,11102,2624,3148,3053,7964,11017,2284,749,1029,1715,3929,14508,31.1716027874564,0.497613771944776,0.325949367088608,0.507386056566384,0.833545108005083,12.6376306620209,FALSE,3,14
"Bill Wennington",720,88,9740,1379,3006,5,36,1374,2970,538,684,688,1460,2148,440,226,248,440,1680,3301,13.5277777777778,0.458749168330007,0.138888888888889,0.462626262626263,0.786549707602339,4.58472222222222,FALSE,3,13
"Bison Dele",413,204,10004,1847,3499,2,14,1845,3485,840,1215,853,1711,2564,440,320,355,822,1297,4536,24.2227602905569,0.527865104315519,0.142857142857143,0.529411764705882,0.691358024691358,10.9830508474576,FALSE,3,8
"Blair Rasmussen",532,282,11409,2248,4767,9,35,2239,4732,614,801,913,2093,3006,467,210,484,460,1623,5119,21.4454887218045,0.471575414306692,0.257142857142857,0.473161453930685,0.766541822721598,9.62218045112782,FALSE,3,8
"Bo Outlaw",997,388,22668,2171,3833,4,40,2167,3793,1000,1939,1832,2969,4801,1568,925,1285,1152,2369,5346,22.7362086258776,0.566397078006783,0.1,0.571315581334036,0.515729757607014,5.36208625877633,FALSE,3,15
"Brad Daugherty",548,546,20029,3823,7189,2,14,3821,7175,2741,3670,1207,4020,5227,2028,422,397,1511,1466,10389,36.5492700729927,0.531784671025177,0.142857142857143,0.532543554006969,0.746866485013624,18.9580291970803,FALSE,3,8
"Brad Miller",1014,716,28900,4104,8521,227,673,3877,7848,3152,3928,2110,5255,7365,2856,767,669,1612,2850,11587,28.5009861932939,0.481633611078512,0.337295690936107,0.49401121304791,0.80244399185336,11.4270216962525,FALSE,3,14
"Brandon Bass",758,283,16410,2558,5125,12,58,2546,5067,1447,1740,1139,2309,3448,608,295,479,718,1375,6575,21.6490765171504,0.499121951219512,0.206896551724138,0.502466942964279,0.831609195402299,8.67414248021108,FALSE,3,12
"Brendan Haywood",893,616,21035,2386,4490,0,5,2386,4485,1470,2491,2359,3231,5590,485,346,1267,950,2252,6242,23.555431131019,0.531403118040089,0,0.531995540691193,0.590124448012846,6.98992161254199,FALSE,3,13
"Brian Cook",534,76,6725,1062,2491,328,881,734,1610,253,318,353,966,1319,294,157,154,315,956,2705,12.5936329588015,0.426334805299077,0.372304199772985,0.455900621118012,0.79559748427673,5.06554307116105,FALSE,3,9
"Brian Grant",756,577,21417,3103,6332,6,28,3097,6304,1721,2306,1834,3788,5622,923,455,561,1235,2409,7933,28.3293650793651,0.490050536955148,0.214285714285714,0.49127538071066,0.746313963573287,10.4933862433862,FALSE,3,12
"Brian Scalabrine",520,61,6772,590,1512,180,523,410,989,234,299,275,759,1034,436,157,121,341,819,1594,13.0230769230769,0.39021164021164,0.344168260038241,0.414560161779575,0.782608695652174,3.06538461538462,FALSE,3,11
"Brian Skinner",722,225,12795,1380,2784,2,7,1378,2777,538,984,1102,2247,3349,361,312,624,604,1491,3300,17.7216066481994,0.495689655172414,0.285714285714286,0.496218941303565,0.546747967479675,4.57063711911357,FALSE,3,14
"Bruno Šundov",107,4,557,83,232,5,24,78,208,13,25,34,83,117,19,15,14,33,115,184,5.20560747663551,0.357758620689655,0.208333333333333,0.375,0.52,1.7196261682243,FALSE,3,7
"Bryant Reeves",395,341,12071,1999,4208,2,27,1997,4181,945,1345,856,1889,2745,623,200,302,744,1365,4945,30.5594936708861,0.47504752851711,0.0740740740740741,0.477636928964363,0.702602230483271,12.5189873417722,FALSE,3,6
"Byron Mullens",234,66,3860,630,1531,144,437,486,1094,183,265,224,658,882,167,89,109,214,399,1587,16.4957264957265,0.411495754408883,0.329519450800915,0.444241316270567,0.690566037735849,6.78205128205128,FALSE,3,5
"Calvin Booth",480,113,5917,646,1417,2,10,644,1407,329,444,427,947,1374,201,146,499,250,912,1623,12.3270833333333,0.455892731122089,0.2,0.45771144278607,0.740990990990991,3.38125,FALSE,3,10
"Carlos Boozer",861,775,26901,5847,11221,1,14,5846,11207,2281,3158,2037,6155,8192,1928,765,346,1824,2612,13976,31.2439024390244,0.521076552891899,0.0714285714285714,0.52163826180066,0.722292590246992,16.2322880371661,FALSE,3,13
"Carlos Rogers",319,55,6030,935,1749,32,126,903,1623,406,722,538,801,1339,200,138,243,311,550,2308,18.9028213166144,0.534591194968553,0.253968253968254,0.55637707948244,0.562326869806094,7.23510971786834,FALSE,3,8
"Charles Jones",1043,449,18909,1262,2701,59,194,1203,2507,728,1176,1478,2821,4299,990,610,1331,803,2575,3311,18.1294343240652,0.467234357645317,0.304123711340206,0.479856402074192,0.619047619047619,3.1744966442953,FALSE,3,15
"Charles Oakley",1282,1159,40280,4835,10263,68,269,4767,9994,2679,3522,3924,8281,12205,3217,1351,384,2785,4421,12417,31.4196567862714,0.471109811945825,0.252788104089219,0.476986191715029,0.760647359454855,9.68564742589704,FALSE,3,19
"Charles Shackleford",303,105,4614,698,1444,0,5,698,1439,229,350,497,951,1448,170,119,148,276,664,1625,15.2277227722772,0.483379501385042,0,0.485059068797776,0.654285714285714,5.36303630363036,FALSE,3,6
"Cherokee Parks",537,182,8513,1002,2122,8,44,994,2078,343,539,635,1297,1932,311,232,342,322,1053,2355,15.852886405959,0.472196041470311,0.181818181818182,0.478344562078922,0.636363636363636,4.3854748603352,FALSE,3,9
"Chris Andersen",722,60,12675,1374,2584,19,82,1355,2502,1093,1668,1212,2379,3591,349,327,1004,522,1371,3860,17.5554016620499,0.531733746130031,0.231707317073171,0.541566746602718,0.655275779376499,5.34626038781163,FALSE,3,15
"Chris Anstey",155,23,2157,303,734,4,29,299,705,203,269,178,356,534,127,78,65,147,373,813,13.9161290322581,0.412806539509537,0.137931034482759,0.424113475177305,0.754646840148699,5.24516129032258,FALSE,3,3
"Chris Bosh",893,881,31936,6209,12581,305,910,5904,11671,4466,5591,1927,5665,7592,1795,730,932,1807,2159,17189,35.7625979843225,0.493521977585248,0.335164835164835,0.505869248564819,0.798783759613665,19.2486002239642,TRUE,3,13
"Chris Dudley",950,361,17677,1537,3735,0,5,1537,3730,749,1690,2408,3472,5880,414,375,1099,824,2492,3823,18.6073684210526,0.411512717536814,0,0.412064343163539,0.443195266272189,4.02421052631579,FALSE,3,16
"Chris Engler",236,2,1682,169,407,0,0,169,407,84,124,172,301,473,53,39,58,105,312,422,7.1271186440678,0.415233415233415,NA,0.415233415233415,0.67741935483871,1.78813559322034,FALSE,3,5
"Chris Gatling",951,92,19056,3939,7726,70,286,3869,7440,2252,3388,1717,3492,5209,635,653,479,1515,2589,10200,20.0378548895899,0.509836914315299,0.244755244755245,0.52002688172043,0.66469893742621,10.7255520504732,FALSE,3,11
"Chris Johnson",288,8,3710,398,940,132,434,266,506,181,231,153,401,554,126,140,102,158,413,1109,12.8819444444444,0.423404255319149,0.304147465437788,0.525691699604743,0.783549783549784,3.85069444444444,FALSE,3,4
"Chris Kaman",735,538,19642,3432,7023,1,24,3431,6999,1343,1808,1487,4095,5582,921,322,931,1544,1968,8208,26.7238095238095,0.488680051260145,0.0416666666666667,0.490212887555365,0.742809734513274,11.1673469387755,FALSE,3,13
"Chris Mihm",512,273,10088,1439,3112,3,13,1436,3099,863,1235,1021,1694,2715,244,165,507,625,1472,3744,19.703125,0.462403598971722,0.230769230769231,0.463375282349145,0.698785425101215,7.3125,FALSE,3,8
"Chris Washburn",109,2,905,129,307,0,1,129,306,54,113,92,159,251,28,16,24,73,109,312,8.30275229357798,0.420195439739414,0,0.42156862745098,0.47787610619469,2.86238532110092,FALSE,3,2
"Chris Webber",959,954,35038,8036,16946,283,938,7753,16008,2817,4294,2525,6648,9173,4032,1351,1294,2602,3057,19172,36.5359749739312,0.474212203469845,0.301705756929638,0.484320339830085,0.656031672100606,19.9916579770594,TRUE,3,15
"Chris Welp",136,6,1371,163,375,0,1,163,374,98,141,106,207,313,52,40,62,81,317,424,10.0808823529412,0.434666666666667,0,0.435828877005348,0.695035460992908,3.11764705882353,FALSE,3,3
"Chris Wilcox",767,291,15052,2542,4704,0,24,2542,4680,1139,1767,1184,2579,3763,554,381,296,852,1837,6223,19.6245110821382,0.540391156462585,0,0.543162393162393,0.644595359366157,8.11342894393742,FALSE,3,11
"Christian Laettner",1020,811,29918,4755,9863,105,405,4650,9458,3451,4204,1923,4786,6709,2545,1059,792,2256,3286,13066,29.3313725490196,0.482104836256717,0.259259259259259,0.49164728272362,0.820884871550904,12.8098039215686,FALSE,3,13
"Chuck Hayes",705,245,12569,1103,2234,0,15,1103,2219,336,535,1188,2265,3453,816,512,249,494,1580,2542,17.8283687943262,0.49373321396598,0,0.497070752591257,0.62803738317757,3.60567375886525,FALSE,3,11
"Chuck Nevitt",184,0,952,114,269,0,0,114,269,72,116,95,176,271,26,22,130,92,246,300,5.17391304347826,0.423791821561338,NA,0.423791821561338,0.620689655172414,1.6304347826087,FALSE,3,9
"Clifford Robinson",1451,873,44250,7591,17398,1320,3708,6271,13690,3622,5262,1906,4609,6515,3198,1464,1443,2568,4356,20124,30.4962095106823,0.43631451891022,0.355987055016181,0.458071585098612,0.688331432915241,13.86905582357,FALSE,3,18
"Clifford Rozier",215,93,3721,429,879,2,13,427,866,156,330,478,653,1131,129,102,157,191,532,1016,17.306976744186,0.488054607508532,0.153846153846154,0.493071593533487,0.472727272727273,4.72558139534884,FALSE,3,4
"Corie Blount",808,89,12810,1240,2685,5,38,1235,2647,460,788,1422,2094,3516,586,438,328,656,1749,2945,15.8539603960396,0.461824953445065,0.131578947368421,0.466565923687193,0.583756345177665,3.64480198019802,FALSE,3,11
"D.J. Mbenga",276,4,1892,219,467,0,2,219,465,59,101,157,266,423,51,44,167,99,356,497,6.85507246376812,0.468950749464668,0,0.470967741935484,0.584158415841584,1.80072463768116,FALSE,3,7
"D.J. White",185,11,2796,459,906,1,5,458,901,159,221,160,435,595,99,51,77,79,276,1078,15.1135135135135,0.506622516556291,0.2,0.508324084350721,0.719457013574661,5.82702702702703,FALSE,3,6
"Dale Davis",1155,891,30913,3704,7013,0,8,3704,7005,1582,2807,3455,5525,8980,1025,723,1335,1133,3040,8990,26.7645021645022,0.528161984885213,0,0.52876516773733,0.56359102244389,7.78354978354978,FALSE,3,16
"Dan Gadzuric",569,173,8256,1103,2229,0,9,1103,2220,377,764,981,1480,2461,210,255,477,386,1341,2583,14.5096660808436,0.494840735755944,0,0.496846846846847,0.493455497382199,4.53954305799649,FALSE,3,10
"Daniel Santiago",122,30,1418,153,326,0,0,153,326,111,162,76,184,260,38,39,47,85,231,417,11.6229508196721,0.469325153374233,NA,0.469325153374233,0.685185185185185,3.41803278688525,FALSE,3,4
"Danny Fortson",440,175,8832,1196,2534,2,12,1194,2522,1221,1556,1195,1989,3184,301,182,94,655,1553,3615,20.0727272727273,0.471981057616417,0.166666666666667,0.473433782712133,0.784704370179949,8.21590909090909,FALSE,3,10
"Danny Schayes",1256,483,24622,3364,7061,4,31,3360,7030,3045,3788,2050,4335,6385,1517,624,948,1848,3864,9777,19.6035031847134,0.476419770570741,0.129032258064516,0.477951635846373,0.803854276663147,7.78423566878981,FALSE,3,18
"Darius Songaila",495,79,9229,1449,2904,3,19,1446,2885,514,609,553,1136,1689,589,324,106,486,1197,3415,18.6444444444444,0.49896694214876,0.157894736842105,0.501213171577123,0.844006568144499,6.8989898989899,FALSE,3,8
"Darko Miličić",555,227,10090,1415,3040,0,9,1415,3031,464,812,719,1554,2273,493,242,724,659,1239,3294,18.1801801801802,0.46546052631579,0,0.466842626195975,0.571428571428571,5.93513513513513,FALSE,3,10
"Darren Tillis",176,9,1782,260,616,0,4,260,612,73,119,157,287,444,60,28,120,95,328,593,10.125,0.422077922077922,0,0.42483660130719,0.61344537815126,3.36931818181818,FALSE,3,2
"Dave Feitl",275,58,3001,471,1089,0,9,471,1080,250,333,241,574,815,125,46,46,234,439,1192,10.9127272727273,0.432506887052342,0,0.436111111111111,0.750750750750751,4.33454545454545,FALSE,3,5
"Dave Hoppen",238,54,3198,434,856,1,8,433,848,254,329,296,564,860,135,59,36,188,505,1123,13.436974789916,0.507009345794392,0.125,0.51061320754717,0.772036474164134,4.71848739495798,FALSE,3,6
"David Andersen",143,0,1637,259,582,43,124,216,458,74,111,94,282,376,70,25,30,81,199,635,11.4475524475524,0.445017182130584,0.346774193548387,0.471615720524017,0.666666666666667,4.44055944055944,FALSE,3,2
"David Harrison",189,33,2686,374,706,0,0,374,706,201,383,184,365,549,47,64,185,216,538,949,14.2116402116402,0.529745042492918,NA,0.529745042492918,0.524804177545692,5.02116402116402,FALSE,3,4
"David Robinson",987,985,34271,7365,14221,25,100,7340,14121,6035,8201,3083,7414,10497,2441,1388,2954,2417,2835,20790,34.7223910840932,0.517896069193446,0.25,0.519793215777919,0.735885867577125,21.063829787234,TRUE,3,14
"Dean Garrett",393,210,7152,740,1559,0,0,740,1559,293,436,613,1254,1867,209,175,382,213,719,1773,18.1984732824427,0.474663245670301,NA,0.474663245670301,0.672018348623853,4.51145038167939,FALSE,3,6
"DeJuan Blair",424,179,7054,1242,2371,0,9,1242,2362,381,627,810,1343,2153,349,316,127,471,1003,2865,16.6367924528302,0.523829607760439,0,0.525825571549534,0.607655502392344,6.75707547169811,FALSE,3,7
"Derrick Alston",139,42,2657,318,650,1,7,317,643,114,234,228,297,525,94,95,87,112,298,751,19.1151079136691,0.489230769230769,0.142857142857143,0.493001555209953,0.487179487179487,5.40287769784173,FALSE,3,3
"Derrick Coleman",781,672,25903,4616,10335,326,1105,4290,9230,3326,4326,2079,5153,7232,1985,606,1051,2036,2062,12884,33.1664532650448,0.446637639090469,0.295022624434389,0.464788732394366,0.768839574664817,16.4967989756722,FALSE,3,15
"DeSagana Diop",755,117,10734,671,1528,1,6,670,1522,238,517,1108,1776,2884,342,282,774,452,1493,1581,14.2172185430464,0.43913612565445,0.166666666666667,0.440210249671485,0.460348162475822,2.09403973509934,FALSE,3,12
"Dickey Simpkins",367,100,5634,543,1213,2,11,541,1202,432,711,450,814,1264,338,100,65,400,647,1520,15.3514986376022,0.44765045342127,0.181818181818182,0.450083194675541,0.607594936708861,4.141689373297,FALSE,3,7
"Dikembe Mutombo",1271,1072,39382,4438,8601,0,2,4438,8599,3602,5251,4115,9259,13374,1316,523,3492,2317,3587,12478,30.985051140834,0.51598651319614,0,0.51610652401442,0.685964578175586,9.81746656176239,TRUE,3,18
"Dino Radja",224,172,7308,1516,3052,0,3,1516,3049,701,954,497,1386,1883,356,201,282,495,745,3733,32.625,0.496723460026212,0,0.497212200721548,0.734800838574423,16.6651785714286,TRUE,3,4
"Donald Hodge",264,35,3616,471,1081,4,14,467,1067,254,357,315,517,832,195,85,103,238,557,1200,13.6969696969697,0.435707678075856,0.285714285714286,0.43767572633552,0.711484593837535,4.54545454545455,FALSE,3,5
"Drew Gooden",1050,673,27141,4644,10060,103,408,4541,9652,2331,3038,2536,5031,7567,1155,716,638,1614,2670,11722,25.8485714285714,0.461630218687873,0.252450980392157,0.470472440944882,0.767281105990783,11.1638095238095,FALSE,3,14
"Duane Causwell",541,262,9409,1029,2029,2,7,1027,2022,588,952,794,1479,2273,243,220,767,500,1471,2648,17.3918669131238,0.507146377525875,0.285714285714286,0.507912957467854,0.61764705882353,4.89463955637708,FALSE,3,11
"Dwayne Schintzius",217,33,1950,256,633,1,8,255,625,74,116,167,369,536,93,30,117,119,321,587,8.98617511520737,0.404423380726698,0.125,0.408,0.637931034482759,2.70506912442396,FALSE,3,8
"Earl Barron",173,40,2449,305,837,3,18,302,819,145,212,242,387,629,79,59,42,134,340,758,14.1560693641618,0.364396654719235,0.166666666666667,0.368742368742369,0.683962264150943,4.38150289017341,FALSE,3,8
"Earl Cureton",752,184,14393,1788,3773,0,18,1788,3755,612,1137,1401,2223,3624,800,374,417,808,1723,4188,19.1396276595745,0.47389345348529,0,0.476165113182423,0.538258575197889,5.56914893617021,FALSE,3,12
"Eddie Griffin",303,117,6729,854,2263,237,752,617,1511,226,337,497,1247,1744,236,105,518,227,506,2171,22.2079207920792,0.377375165709236,0.315159574468085,0.408338848444739,0.670623145400593,7.16501650165017,FALSE,3,5
"Eddie Lee Wilkins",322,29,3787,596,1267,0,9,596,1258,342,606,400,602,1002,62,82,60,288,609,1534,11.7608695652174,0.470402525651144,0,0.473767885532591,0.564356435643564,4.7639751552795,FALSE,3,6
"Eddy Curry",527,411,13109,2578,4734,2,2,2576,4732,1662,2588,947,1778,2725,287,155,384,1174,1562,6820,24.8747628083491,0.544571187156738,1,0.544378698224852,0.642194744976816,12.9411764705882,FALSE,3,11
"Elden Campbell",1189,706,28494,4440,9718,2,41,4438,9677,3002,4292,2081,4706,6787,1338,782,1721,1526,3351,11884,23.9646761984861,0.456884132537559,0.048780487804878,0.458613206572285,0.699440820130475,9.99495374264087,FALSE,3,15
"Elmore Spencer",174,75,2699,394,767,0,3,394,764,149,256,130,438,568,110,53,172,255,348,937,15.5114942528736,0.513689700130378,0,0.515706806282722,0.58203125,5.38505747126437,FALSE,3,5
"Elton Brand",1058,868,34910,6599,13185,2,21,6597,13164,3627,4929,3304,5736,9040,2184,940,1828,2060,3115,16827,32.9962192816635,0.500492984452029,0.0952380952380952,0.501139471285324,0.735849056603774,15.9045368620038,FALSE,3,17
"Eric Leckner",541,63,6696,858,1730,0,5,858,1725,477,734,449,1300,1749,255,101,164,465,1241,2193,12.3770794824399,0.495953757225434,0,0.497391304347826,0.649863760217984,4.0536044362292,FALSE,3,8
"Eric Mobley",152,42,2246,254,471,4,6,250,465,116,249,193,298,491,79,41,85,153,281,628,14.7763157894737,0.53927813163482,0.666666666666667,0.53763440860215,0.465863453815261,4.13157894736842,FALSE,3,3
"Eric Montross",645,416,11647,1167,2450,0,3,1167,2447,334,737,1018,2031,3049,298,166,401,552,1780,2668,18.0573643410853,0.476326530612245,0,0.476910502656314,0.453188602442334,4.13643410852713,FALSE,3,8
"Eric Riley",186,41,1844,218,478,0,4,218,474,138,196,180,299,479,60,54,132,126,303,574,9.91397849462366,0.456066945606695,0,0.459915611814346,0.704081632653061,3.08602150537634,FALSE,3,5
"Erick Dampier",987,771,24003,2784,5595,2,16,2782,5579,1739,2779,2723,4282,7005,817,330,1398,1435,2869,7309,24.3191489361702,0.497587131367292,0.125,0.498655673059688,0.625764663548039,7.40526849037487,FALSE,3,16
"Ervin Johnson",845,452,16989,1393,2756,2,10,1391,2746,685,1133,1677,3471,5148,387,471,1087,724,2430,3473,20.105325443787,0.50544267053701,0.2,0.506554989075018,0.60458958517211,4.11005917159763,FALSE,3,13
"Etan Thomas",409,74,7084,890,1734,0,0,890,1734,561,930,677,1250,1927,149,128,427,385,889,2341,17.320293398533,0.513264129181084,NA,0.513264129181084,0.603225806451613,5.72371638141809,FALSE,3,9
"Evan Eschmeyer",153,65,2138,158,341,0,0,158,341,105,169,220,381,601,76,69,95,96,399,421,13.9738562091503,0.463343108504399,NA,0.463343108504399,0.621301775147929,2.7516339869281,FALSE,3,4
"Fabricio Oberto",336,128,4871,481,835,0,4,481,831,119,193,443,732,1175,300,89,75,225,733,1081,14.4970238095238,0.576047904191617,0,0.578820697954272,0.616580310880829,3.2172619047619,FALSE,3,6
"Felton Spencer",713,469,13856,1333,2750,0,1,1333,2749,1060,1630,1470,2382,3852,235,282,584,755,2391,3726,19.4333800841515,0.484727272727273,0,0.484903601309567,0.650306748466258,5.2258064516129,FALSE,3,12
"Festus Ezeli",170,61,2394,275,536,0,0,275,536,162,291,292,433,725,63,48,166,133,328,712,14.0823529411765,0.513059701492537,NA,0.513059701492537,0.556701030927835,4.18823529411765,FALSE,3,3
"Francisco Elson",547,154,8086,822,1768,3,17,819,1751,301,432,553,1299,1852,286,244,275,403,1103,1948,14.782449725777,0.464932126696833,0.176470588235294,0.467732724157624,0.696759259259259,3.56124314442413,FALSE,3,9
"Frank Brickowski",846,450,18859,3304,6416,59,194,3245,6222,1746,2352,1140,2790,3930,1623,744,318,1585,2658,8413,22.2919621749409,0.514962593516209,0.304123711340206,0.521536483445837,0.74234693877551,9.94444444444444,FALSE,3,12
"Fred Roberts",892,253,15881,2465,4914,52,158,2413,4756,1547,1936,912,1582,2494,1064,440,275,1058,1713,6529,17.8038116591928,0.501628001628002,0.329113924050633,0.507359125315391,0.799070247933884,7.3195067264574,FALSE,3,13
"Gary Trent",560,150,11226,2033,4085,8,62,2025,4023,922,1422,965,1649,2614,576,258,201,693,1257,4996,20.0464285714286,0.497674418604651,0.129032258064516,0.503355704697987,0.648382559774965,8.92142857142857,FALSE,3,9
"George Zídek",199,25,1768,217,542,2,8,215,534,189,239,147,242,389,48,19,17,100,312,625,8.88442211055276,0.400369003690037,0.25,0.402621722846442,0.790794979079498,3.14070351758794,FALSE,3,3
"Gheorghe Mureșan",307,207,6729,1265,2206,0,1,1265,2205,490,761,658,1299,1957,150,171,455,446,958,3020,21.9185667752443,0.573436083408885,0,0.573696145124717,0.64388961892247,9.8371335504886,FALSE,3,6
"Glen Davis",582,165,12527,1885,4204,14,66,1871,4138,968,1384,839,1748,2587,534,415,202,604,1397,4752,21.5240549828179,0.448382492863939,0.212121212121212,0.452150797486709,0.699421965317919,8.16494845360825,FALSE,3,8
"Granville Waiters",249,39,2547,270,589,0,5,270,584,66,118,183,357,540,121,56,185,153,410,606,10.2289156626506,0.458404074702886,0,0.462328767123288,0.559322033898305,2.43373493975904,FALSE,3,5
"Greg Anderson",748,317,14964,2127,4360,2,24,2125,4336,989,1783,1529,3035,4564,401,515,635,1010,1881,5245,20.0053475935829,0.487844036697248,0.0833333333333333,0.490083025830258,0.554683118339877,7.0120320855615,FALSE,3,10
"Greg Dreiling",474,94,4241,375,803,3,9,372,794,261,402,287,731,1018,186,82,137,250,923,1014,8.94725738396624,0.466998754669988,0.333333333333333,0.468513853904282,0.649253731343284,2.13924050632911,FALSE,3,10
"Greg Foster",777,98,9416,1252,2820,27,116,1225,2704,517,699,626,1407,2033,411,112,236,561,1462,3048,12.1184041184041,0.443971631205674,0.232758620689655,0.453032544378698,0.739628040057225,3.92277992277992,FALSE,3,13
"Greg Kite",814,268,12162,876,2007,1,7,875,2000,346,714,1081,2055,3136,429,217,526,680,1918,2099,14.9410319410319,0.436472346786248,0.142857142857143,0.4375,0.484593837535014,2.57862407862408,FALSE,3,12
"Greg Oden",105,66,2028,317,552,0,0,317,552,206,313,256,400,656,51,40,130,138,374,840,19.3142857142857,0.574275362318841,NA,0.574275362318841,0.65814696485623,8,FALSE,3,3
"Greg Ostertag",756,321,14753,1339,2757,1,10,1338,2747,833,1465,1475,2670,4145,443,189,1293,684,1873,3512,19.5145502645503,0.485672832789264,0.1,0.487076811066618,0.568600682593857,4.64550264550265,FALSE,3,11
"Greg Stiemsma",203,42,3048,269,529,0,1,269,528,103,146,190,489,679,97,118,232,143,512,641,15.0147783251232,0.508506616257089,0,0.509469696969697,0.705479452054795,3.1576354679803,FALSE,3,4
"Gustavo Ayón",190,44,2985,376,697,0,1,376,696,87,183,248,540,788,244,122,90,169,379,839,15.7105263157895,0.539454806312769,0,0.540229885057471,0.475409836065574,4.41578947368421,FALSE,3,3
"Hakeem Olajuwon",1238,1186,44222,10749,20991,25,124,10724,20867,5423,7621,4034,9714,13748,3058,2162,3830,3667,4383,26946,35.7205169628433,0.512076604258968,0.201612903225806,0.513921502851392,0.711586405983467,21.7657512116317,TRUE,3,18
"Hamed Haddadi",181,0,1378,165,363,0,5,165,358,93,152,180,303,483,55,17,119,123,269,423,7.61325966850829,0.454545454545455,0,0.460893854748603,0.611842105263158,2.33701657458564,FALSE,3,5
"Hanno Möttölä",155,17,2360,292,661,1,16,291,645,130,166,130,312,442,75,31,28,137,337,715,15.2258064516129,0.441754916792738,0.0625,0.451162790697674,0.783132530120482,4.61290322580645,FALSE,3,2
"Hasheem Thabeet",291,23,2869,210,382,0,0,210,382,151,261,243,469,712,31,69,210,148,549,571,9.85910652920962,0.549738219895288,NA,0.549738219895288,0.578544061302682,1.96219931271478,FALSE,3,5
"Henry Sims",181,86,3417,533,1130,4,24,529,1106,311,409,352,555,907,192,104,84,194,405,1381,18.878453038674,0.471681415929204,0.166666666666667,0.478300180831826,0.76039119804401,7.62983425414365,FALSE,3,4
"Herb Williams",1222,675,31525,5421,11672,9,93,5412,11579,2008,2889,1774,5418,7192,2007,665,1772,2100,3191,12859,25.7978723404255,0.464444825222755,0.0967741935483871,0.467397875464202,0.695050190377293,10.5229132569558,FALSE,3,18
"Hilton Armstrong",378,42,4201,412,848,4,12,408,836,215,381,361,617,978,137,123,175,280,687,1043,11.1137566137566,0.485849056603774,0.333333333333333,0.488038277511962,0.564304461942257,2.75925925925926,FALSE,3,6
"Horace Grant",1165,1037,38621,5439,10695,4,63,5435,10632,2114,3053,3467,5976,9443,2575,1143,1136,1303,2832,12996,33.1510729613734,0.508555399719495,0.0634920634920635,0.511192626034612,0.692433671798231,11.155364806867,FALSE,3,17
"Hot Rod Williams",887,518,26327,3688,7681,2,19,3686,7662,2406,3315,2070,3928,5998,1592,746,1456,1208,2253,9784,29.6809470124014,0.48014581434709,0.105263157894737,0.481075437222657,0.72579185520362,11.0304396843292,FALSE,3,13
"Isaac Austin",510,216,10616,1701,3772,9,59,1692,3713,929,1387,816,1771,2587,713,275,282,907,1198,4340,20.8156862745098,0.450954400848356,0.152542372881356,0.455696202531646,0.669790915645278,8.50980392156863,FALSE,3,9
"J.J. Hickson",623,335,13605,2312,4603,0,24,2312,4579,1115,1830,1345,2761,4106,517,319,358,869,1165,5739,21.8378812199037,0.502281121008038,0,0.504913736623717,0.609289617486339,9.21187800963082,FALSE,3,8
"J.R. Reid",861,369,19599,2743,5790,5,44,2738,5746,1765,2428,1242,3062,4304,809,641,322,1202,2565,7256,22.7630662020906,0.473747841105354,0.113636363636364,0.476505395057431,0.726935749588138,8.4274099883856,FALSE,3,11
"Jabari Smith",131,2,1244,151,366,1,11,150,355,99,145,57,149,206,77,43,32,59,197,402,9.49618320610687,0.412568306010929,0.0909090909090909,0.422535211267606,0.682758620689655,3.06870229007634,FALSE,3,4
"Jack Haley",408,80,4372,572,1369,0,4,572,1365,397,601,455,767,1222,108,78,60,288,744,1541,10.7156862745098,0.417823228634039,0,0.419047619047619,0.660565723793677,3.77696078431373,FALSE,3,9
"Jackson Vroman",133,38,1816,190,464,0,6,190,458,117,194,161,275,436,91,62,49,149,288,497,13.6541353383459,0.40948275862069,0,0.414847161572052,0.603092783505155,3.73684210526316,FALSE,3,2
"Jahidi White",396,226,6778,835,1633,0,1,835,1632,545,1029,804,1401,2205,70,144,406,463,1063,2215,17.1161616161616,0.511328842620943,0,0.511642156862745,0.529640427599611,5.59343434343434,FALSE,3,7
"Jake Tsakalidis",351,175,5395,609,1256,0,1,609,1255,363,552,478,864,1342,106,81,235,292,740,1581,15.3703703703704,0.484872611464968,0,0.485258964143426,0.657608695652174,4.5042735042735,FALSE,3,7
"Jake Voskuhl",450,93,6443,673,1381,1,3,672,1378,467,654,562,977,1539,237,148,166,340,1166,1814,14.3177777777778,0.487328023171615,0.333333333333333,0.48766328011611,0.714067278287462,4.03111111111111,FALSE,3,9
"Jamaal Magloire",711,316,14907,1781,3730,0,7,1781,3723,1411,2220,1437,3060,4497,393,225,613,1028,1842,4973,20.9662447257384,0.477479892761394,0,0.478377652430835,0.635585585585586,6.9943741209564,FALSE,3,12
"James Donaldson",1098,NA,29979,3473,6146,0,0,3473,6146,2258,3062,2330,6246,8576,894,372,1455,1625,2317,9204,27.3032786885246,0.565082980800521,NA,0.565082980800521,0.737426518615284,8.38251366120219,FALSE,3,14
"Jamie Feick",270,51,5792,474,1118,17,44,457,1074,274,440,709,1230,1939,189,158,122,217,590,1239,21.4518518518519,0.42397137745975,0.386363636363636,0.425512104283054,0.622727272727273,4.58888888888889,FALSE,3,5
"Jarron Collins",570,216,8723,688,1521,0,5,688,1516,738,1056,659,944,1603,421,142,99,341,1345,2114,15.3035087719298,0.452333990795529,0,0.453825857519789,0.698863636363636,3.70877192982456,FALSE,3,10
"Jason Collier",151,65,2178,338,743,7,20,331,723,158,214,175,268,443,51,36,32,120,295,841,14.4238410596026,0.454912516823688,0.35,0.457814661134163,0.738317757009346,5.56953642384106,FALSE,3,5
"Jason Collins",847,512,16530,980,2376,7,35,973,2341,835,1308,1001,1943,2944,659,403,394,671,2335,2802,19.5159386068477,0.412457912457912,0.2,0.415634344297309,0.638379204892966,3.30814639905549,FALSE,3,13
"Jason Maxiell",618,188,11379,1398,2823,0,5,1398,2818,685,1214,1048,1528,2576,266,230,490,487,1197,3481,18.4126213592233,0.495217853347503,0,0.496096522356281,0.564250411861615,5.6326860841424,FALSE,3,10
"Jason Thompson",635,419,15290,2164,4363,11,57,2153,4306,1018,1546,1296,2718,4014,664,295,434,762,1831,5357,24.0787401574803,0.495988998395599,0.192982456140351,0.5,0.658473479948254,8.43622047244095,FALSE,3,8
"Jawann Oldham",335,NA,5286,611,1275,0,3,611,1272,242,401,435,934,1369,163,99,549,366,829,1464,15.7791044776119,0.47921568627451,0,0.480345911949686,0.603491271820449,4.37014925373134,FALSE,3,10
"Jayson Williams",475,158,9805,1360,3092,3,24,1357,3068,749,1236,1587,1997,3584,287,204,301,515,1284,3472,20.6421052631579,0.439844760672704,0.125,0.442307692307692,0.605987055016181,7.30947368421053,FALSE,3,9
"Jeff Ayres",237,15,2322,287,519,2,5,285,514,114,147,196,436,632,99,37,66,132,360,690,9.79746835443038,0.552986512524085,0.4,0.554474708171206,0.775510204081633,2.91139240506329,FALSE,3,6
"Jeff Foster",764,345,15750,1472,2961,7,54,1465,2907,796,1295,2101,3147,5248,703,507,308,613,1921,3747,20.6151832460733,0.497129348193178,0.12962962962963,0.503955968352253,0.614671814671815,4.9044502617801,FALSE,3,13
"Jeff Ruland",332,189,11088,2105,3734,3,19,2102,3715,1550,2159,1082,2296,3378,1002,249,267,1212,1218,5763,33.3975903614458,0.56373861810391,0.157894736842105,0.565814266487214,0.717924965261695,17.3584337349398,FALSE,3,8
"Jeff Wilkins",529,NA,11130,1648,3644,0,10,1648,3634,631,864,671,2175,2846,508,189,267,683,1360,3927,21.0396975425331,0.45225027442371,0,0.453494771601541,0.730324074074074,7.4234404536862,FALSE,3,6
"Jelani McCoy",260,72,3824,510,947,0,0,510,947,180,367,285,636,921,135,75,193,245,521,1200,14.7076923076923,0.538542766631468,NA,0.538542766631468,0.490463215258856,4.61538461538461,FALSE,3,8
"Jeremy Tyler",125,23,1102,166,373,0,1,166,372,63,112,104,185,289,26,24,44,74,174,395,8.816,0.445040214477212,0,0.446236559139785,0.5625,3.16,FALSE,3,3
"Jermaine O'Neal",1079,758,29391,5509,11795,14,96,5495,11699,3182,4430,2117,5577,7694,1491,499,1956,2016,3107,14214,27.2391102873031,0.467062314540059,0.145833333333333,0.469698264808958,0.718284424379232,13.1733086190918,FALSE,3,18
"Jerome James",358,180,4771,650,1339,0,2,650,1337,240,389,393,706,1099,118,92,384,403,989,1540,13.3268156424581,0.485436893203884,0,0.486163051608078,0.616966580976864,4.30167597765363,FALSE,3,9
"Jérôme Moïso",165,4,1512,167,341,0,4,167,337,80,131,136,296,432,39,48,74,111,196,414,9.16363636363636,0.489736070381232,0,0.495548961424332,0.610687022900763,2.50909090909091,FALSE,3,5
"Jim McIlvaine",401,214,5927,423,948,1,10,422,938,225,408,479,764,1243,105,136,691,231,1052,1072,14.7805486284289,0.44620253164557,0.1,0.449893390191898,0.551470588235294,2.67331670822943,FALSE,3,7
"Jim Petersen",491,208,9802,1371,2821,2,28,1369,2793,653,901,766,1588,2354,487,213,363,662,1354,3397,19.9633401221996,0.485997873094647,0.0714285714285714,0.49015395631937,0.724750277469478,6.91853360488798,FALSE,3,8
"Joe Barry Carroll",858,NA,26563,5735,12266,0,17,5735,12249,2722,3634,1954,4382,6336,1474,784,1342,2270,2599,14192,30.9592074592075,0.467552584379586,0,0.468201485835578,0.749036873968079,16.5407925407925,FALSE,3,10
"Joe Kleine",1099,227,16971,2146,4803,15,53,2131,4750,1011,1259,1454,3118,4572,724,311,326,922,2290,5318,15.442220200182,0.446804080782844,0.283018867924528,0.448631578947368,0.803018268467037,4.83894449499545,FALSE,3,15
"Joe Smith",1324,727,33766,5474,12061,33,149,5441,11912,3095,3929,3030,5101,8131,1264,756,1037,1625,3706,14076,25.5030211480363,0.453859547301219,0.221476510067114,0.456766286098052,0.787732247391194,10.631419939577,FALSE,3,16
"Joe Wolf",679,135,10866,1223,2830,18,117,1205,2713,365,475,658,1510,2168,664,279,137,558,1466,2829,16.0029455081001,0.432155477031802,0.153846153846154,0.444157758938445,0.768421052631579,4.16642120765832,FALSE,3,11
"Joel Anthony",523,110,7242,410,808,0,0,410,808,272,413,577,814,1391,101,130,543,230,836,1092,13.8470363288719,0.507425742574257,NA,0.507425742574257,0.658595641646489,2.08795411089866,FALSE,3,10
"Joel Freeland",151,9,1821,209,455,0,2,209,453,59,81,190,328,518,65,32,56,74,255,477,12.0596026490066,0.459340659340659,0,0.461368653421634,0.728395061728395,3.15894039735099,FALSE,3,3
"Joel Przybilla",645,418,12599,939,1718,0,3,939,1715,528,958,1181,2740,3921,276,167,868,621,1736,2406,19.5333333333333,0.546565774155995,0,0.547521865889213,0.551148225469729,3.73023255813954,FALSE,3,13
"Joey Dorsey",145,26,1594,151,286,0,1,151,285,65,172,214,342,556,57,70,46,92,277,367,10.9931034482759,0.527972027972028,0,0.529824561403509,0.377906976744186,2.53103448275862,FALSE,3,4
"Johan Petro",522,161,7821,1049,2290,2,15,1047,2275,264,395,578,1416,1994,243,212,249,402,1265,2364,14.9827586206897,0.458078602620087,0.133333333333333,0.46021978021978,0.668354430379747,4.52873563218391,FALSE,3,8
"John Amaechi",294,93,4811,663,1646,1,13,662,1633,510,760,230,542,772,228,90,94,386,499,1837,16.3639455782313,0.402794653705954,0.0769230769230769,0.40538885486834,0.671052631578947,6.24829931972789,FALSE,3,5
"John Salley",790,234,17197,1934,3837,3,14,1931,3823,1542,2161,1272,2224,3496,970,470,1010,1004,2509,5413,21.7683544303797,0.504039614281991,0.214285714285714,0.505100706251635,0.713558537714021,6.85189873417722,FALSE,3,11
"John Shasky",136,4,1505,176,378,0,2,176,376,165,252,158,221,379,34,29,35,75,179,517,11.0661764705882,0.465608465608466,0,0.468085106382979,0.654761904761905,3.80147058823529,FALSE,3,3
"John Thomas",278,29,2915,284,572,0,2,284,570,158,251,257,301,558,79,94,64,161,498,726,10.4856115107914,0.496503496503497,0,0.498245614035088,0.629482071713147,2.61151079136691,FALSE,3,5
"Jon Brockman",150,10,1570,118,242,0,1,118,241,84,136,212,260,472,49,33,9,57,267,320,10.4666666666667,0.487603305785124,0,0.489626556016597,0.61764705882353,2.13333333333333,FALSE,3,3
"Jon Koncak",784,379,16409,1444,3073,19,84,1425,2989,613,1027,1064,2792,3856,785,542,791,624,2474,3520,20.9298469387755,0.469899121379759,0.226190476190476,0.476748076279692,0.596884128529698,4.48979591836735,FALSE,3,11
"Jordan Hill",495,128,8867,1538,3099,3,27,1535,3072,591,852,1016,1734,2750,358,178,320,487,1038,3670,17.9131313131313,0.496289125524363,0.111111111111111,0.499674479166667,0.693661971830986,7.41414141414141,FALSE,3,8
"Josh Boone",256,88,4482,567,1042,0,0,567,1042,206,463,484,774,1258,125,99,178,169,466,1340,17.5078125,0.544145873320537,NA,0.544145873320537,0.444924406047516,5.234375,FALSE,3,4
"Josh Powell",353,28,4319,541,1229,7,20,534,1209,253,342,355,665,1020,182,54,80,283,552,1342,12.2351274787535,0.440195280716029,0.35,0.441687344913151,0.739766081871345,3.80169971671388,FALSE,3,7
"Justin Hamilton",162,35,2745,362,775,81,260,281,515,127,156,193,351,544,127,93,103,103,247,932,16.9444444444444,0.467096774193548,0.311538461538462,0.545631067961165,0.814102564102564,5.75308641975309,FALSE,3,3
"Juwan Howard",1412,1055,42735,7663,16320,6,55,7657,16265,3647,4774,2772,5916,8688,3082,946,402,2889,4121,18979,30.2655807365439,0.469546568627451,0.109090909090909,0.470765447279434,0.763929618768328,13.4412181303116,FALSE,3,19
"Keith Closs",130,7,1647,201,427,0,4,201,423,100,165,133,239,372,44,28,163,78,167,502,12.6692307692308,0.470725995316159,0,0.475177304964539,0.606060606060606,3.86153846153846,FALSE,3,3
"Kelvin Cato",568,248,10950,1159,2300,1,13,1158,2287,739,1142,904,2040,2944,248,298,697,466,1399,3058,19.2781690140845,0.503913043478261,0.0769230769230769,0.506340183646699,0.647110332749562,5.38380281690141,FALSE,3,10
"Kenyon Martin",757,667,23134,3875,8031,66,282,3809,7749,1509,2398,1312,3847,5159,1439,893,864,1318,2498,9325,30.560105680317,0.482505291993525,0.234042553191489,0.491547296425345,0.629274395329441,12.3183619550859,FALSE,3,15
"Keon Clark",434,68,9691,1428,2878,1,20,1427,2858,665,1051,791,1739,2530,394,216,725,560,1257,3522,22.3294930875576,0.496177901320361,0.05,0.499300209937019,0.632730732635585,8.11520737327189,FALSE,3,6
"Kevin Duckworth",749,528,18337,3346,7143,5,25,3341,7118,1740,2373,1445,2723,4168,627,350,337,1315,2387,8437,24.4819759679573,0.468430631387372,0.2,0.46937341949986,0.733249051833123,11.2643524699599,FALSE,3,11
"Kevin Garnett",1509,1472,51370,10648,21448,175,639,10473,20809,4923,6235,3257,11716,14973,5522,1905,2054,3225,3670,26394,34.0424121935056,0.496456546064901,0.273865414710485,0.503291844874814,0.789574979951885,17.4910536779324,TRUE,3,21
"Kevin Séraphin",423,34,6430,1134,2318,0,7,1134,2311,248,347,502,960,1462,246,88,304,449,903,2516,15.2009456264775,0.489214840379638,0,0.490696668109044,0.714697406340058,5.94799054373522,FALSE,3,7
"Kevin Willis",1644,1036,44717,8197,16989,45,220,8152,16769,3484,4884,4744,9059,13803,1517,1107,879,2930,4856,19923,27.2001216545012,0.482488669138855,0.204545454545455,0.486135130299958,0.713349713349713,12.1186131386861,FALSE,3,21
"Kurt Nimphius",710,287,14755,1957,4005,2,27,1955,3978,973,1427,1115,1999,3114,768,244,855,742,2054,4889,20.7816901408451,0.488639200998752,0.0740740740740741,0.491452991452991,0.681850035038542,6.88591549295775,FALSE,3,8
"Kurt Thomas",1180,698,28744,4031,8290,9,33,4022,8257,1345,1781,2052,5783,7835,1271,780,898,1287,3767,9416,24.3593220338983,0.486248492159228,0.272727272727273,0.487101852973235,0.755193711398091,7.97966101694915,FALSE,3,18
"Kwame Brown",645,296,14102,1590,3230,1,9,1589,3221,1038,1848,1136,2385,3521,599,346,399,822,1467,4219,21.8635658914729,0.492260061919505,0.111111111111111,0.493325054330953,0.561688311688312,6.54108527131783,FALSE,3,12
"Kyrylo Fesenko",135,7,1107,125,252,0,2,125,250,55,134,97,172,269,40,19,53,66,224,305,8.2,0.496031746031746,0,0.5,0.41044776119403,2.25925925925926,FALSE,3,5
"Larry Sanders",238,113,4635,669,1395,0,5,669,1390,182,329,475,870,1345,174,152,429,224,666,1520,19.4747899159664,0.479569892473118,0,0.481294964028777,0.553191489361702,6.38655462184874,FALSE,3,6
"LaSalle Thompson",1087,587,23707,3555,7245,4,27,3551,7218,1761,2362,2354,5087,7441,1222,823,1072,1834,3461,8875,21.8095676172953,0.490683229813665,0.148148148148148,0.491964533111665,0.745554614733277,8.16467341306348,FALSE,3,15
"Lavoy Allen",453,89,7977,962,2058,4,28,958,2030,222,327,834,1320,2154,455,144,247,301,832,2150,17.6092715231788,0.467444120505345,0.142857142857143,0.47192118226601,0.678899082568807,4.74613686534216,FALSE,3,6
"Leon Powe",269,22,3648,549,1071,0,7,549,1064,544,811,404,570,974,85,79,86,201,547,1642,13.5613382899628,0.512605042016807,0,0.515977443609023,0.670776818742293,6.10408921933085,FALSE,3,5
"Lonny Baxter",265,10,3050,395,843,2,8,393,835,214,327,287,494,781,64,65,96,166,503,1006,11.5094339622642,0.468564650059312,0.25,0.470658682634731,0.654434250764526,3.79622641509434,FALSE,3,4
"Loren Meyer",194,87,2752,368,846,12,30,356,816,163,232,224,401,625,96,42,65,195,496,911,14.1855670103093,0.434988179669031,0.4,0.436274509803922,0.702586206896552,4.69587628865979,FALSE,3,3
"Loren Woods",215,47,2428,208,496,1,7,207,489,138,215,263,419,682,74,55,128,138,278,555,11.293023255814,0.419354838709677,0.142857142857143,0.423312883435583,0.641860465116279,2.58139534883721,FALSE,3,6
"Lorenzen Wright",796,448,18696,2562,5594,2,29,2560,5565,1080,1676,1696,3285,4981,626,474,575,881,2307,6206,23.4874371859296,0.457990704326064,0.0689655172413793,0.460017969451932,0.644391408114558,7.7964824120603,FALSE,3,13
"Lorenzo Williams",318,184,6430,404,867,0,3,404,864,95,250,805,1070,1875,277,157,413,266,853,903,20.2201257861635,0.465974625144175,0,0.467592592592593,0.38,2.83962264150943,FALSE,3,7
"Luc Longley",643,408,13508,1904,4112,0,6,1904,4106,810,1072,1001,2226,3227,945,323,628,1061,1946,4618,21.0077760497667,0.463035019455253,0,0.463711641500244,0.755597014925373,7.18195956454121,FALSE,3,10
"Maciej Lampe",107,0,1040,145,374,4,12,141,362,40,61,65,175,240,35,13,17,55,134,334,9.7196261682243,0.387700534759358,0.333333333333333,0.389502762430939,0.655737704918033,3.1214953271028,FALSE,3,3
"Manute Bol",638,133,11814,669,1654,43,208,626,1446,226,403,599,2066,2665,172,128,2102,456,1470,1607,18.5172413793103,0.40447400241838,0.206730769230769,0.432918395573997,0.560794044665012,2.51880877742947,FALSE,3,10
"Marc Jackson",490,116,9094,1428,3213,8,34,1420,3179,975,1198,764,1236,2000,369,171,116,562,970,3839,18.5591836734694,0.444444444444444,0.235294117647059,0.446681346335326,0.813856427378965,7.83469387755102,FALSE,3,7
"Marcus Camby",1106,913,32350,4133,8865,22,100,4111,8765,1817,2737,3017,7897,10914,2130,1112,2562,1510,2974,10105,29.249547920434,0.466215454032713,0.22,0.469024529378209,0.663865546218487,9.13652802893309,FALSE,3,17
"Mark Acres",393,75,6251,540,1065,8,15,532,1050,319,479,607,985,1592,185,140,110,248,966,1407,15.9058524173028,0.507042253521127,0.533333333333333,0.506666666666667,0.665970772442589,3.58015267175573,FALSE,3,6
"Mark Blount",767,479,17624,2543,5092,37,103,2506,4989,1133,1556,1102,2355,3457,668,409,652,1230,1995,6256,22.9778357235984,0.499410840534171,0.359223300970874,0.502305071156544,0.728149100257069,8.15645371577575,FALSE,3,9
"Mark Bryant",813,198,13579,1744,3500,1,12,1743,3488,837,1200,1128,1884,3012,495,331,196,668,2036,4326,16.7023370233702,0.498285714285714,0.0833333333333333,0.499713302752294,0.6975,5.3210332103321,FALSE,3,15
"Mark Eaton",875,815,25169,2072,4526,0,2,2072,4524,1072,1653,1857,5082,6939,840,368,3064,1293,2955,5216,28.7645714285714,0.457799381352187,0,0.458001768346596,0.648517846339988,5.96114285714286,FALSE,3,11
"Mark Madsen",453,70,5335,381,834,1,16,380,818,212,402,559,598,1157,181,116,102,206,866,975,11.7770419426049,0.456834532374101,0.0625,0.464547677261614,0.527363184079602,2.1523178807947,FALSE,3,9
"Mark McNamara",323,25,2980,402,783,0,0,402,783,288,529,376,525,901,83,42,47,242,401,1092,9.22600619195046,0.513409961685824,NA,0.513409961685824,0.544423440453686,3.38080495356037,FALSE,3,8
"Mark West",1239,614,23199,2950,5123,0,6,2950,5117,1416,2489,2040,4081,6121,517,386,1599,1440,3598,7316,18.7239709443099,0.575834471989069,0,0.576509673636897,0.568903173965448,5.9047619047619,FALSE,3,17
"Marty Conlon",409,38,6895,1062,2107,15,77,1047,2030,548,740,551,898,1449,412,157,81,446,753,2687,16.8581907090465,0.504034171808258,0.194805194805195,0.51576354679803,0.74054054054054,6.56968215158924,FALSE,3,9
"Matt Bonner",792,112,13356,1749,3768,797,1923,952,1845,337,432,622,1749,2371,552,285,213,299,1307,4632,16.8636363636364,0.464171974522293,0.414456578263131,0.515989159891599,0.780092592592593,5.84848484848485,FALSE,3,12
"Matt Geiger",552,214,12221,2039,4083,16,69,2023,4014,965,1325,1152,2006,3158,388,306,347,744,1629,5059,22.1394927536232,0.499387705118785,0.231884057971014,0.503986048829098,0.728301886792453,9.16485507246377,FALSE,3,10
"Maurice Taylor",599,243,14660,2674,5744,8,42,2666,5702,1005,1427,858,1851,2709,690,273,279,1067,1783,6361,24.4741235392321,0.465529247910864,0.19047619047619,0.467555243774114,0.70427470217239,10.6193656093489,FALSE,3,9
"Mehmet Okur",634,460,18429,3028,6615,596,1590,2432,5025,1909,2396,1261,3175,4436,1089,329,453,991,1815,8561,29.0678233438486,0.457747543461829,0.374842767295597,0.483980099502488,0.796744574290484,13.5031545741325,FALSE,3,10
"Melvin Ely",405,55,6314,812,1782,0,3,812,1779,457,729,463,805,1268,279,105,217,420,816,2081,15.5901234567901,0.455667789001122,0,0.456436200112423,0.626886145404664,5.13827160493827,FALSE,3,9
"Melvin Turpin",361,127,6871,1297,2513,1,9,1296,2504,476,613,575,1080,1655,183,155,348,431,853,3071,19.0332409972299,0.516116195781934,0.111111111111111,0.517571884984026,0.776508972267537,8.50692520775623,FALSE,3,5
"Michael Bradley",207,14,2233,240,496,2,15,238,481,49,98,237,405,642,99,29,49,125,226,531,10.7874396135266,0.483870967741935,0.133333333333333,0.494802494802495,0.5,2.56521739130435,FALSE,3,5
"Michael Cage",1140,733,29716,3317,6445,0,25,3317,6420,1644,2476,3227,5419,8646,1057,1050,725,1161,2581,8278,26.0666666666667,0.51466252909232,0,0.516666666666667,0.663974151857835,7.26140350877193,FALSE,3,15
"Michael Doleac",659,84,9818,1386,3160,1,8,1385,3152,434,544,670,1550,2220,387,223,245,424,1457,3207,14.8983308042489,0.438607594936709,0.125,0.439403553299492,0.797794117647059,4.86646433990895,FALSE,3,10
"Michael Olowokandi",548,417,14048,1895,4349,0,0,1895,4349,583,983,1001,2633,3634,350,248,730,953,1640,4373,25.6350364963504,0.435732352264888,NA,0.435732352264888,0.593082400813835,7.97992700729927,FALSE,3,9
"Michael Ruffin",414,58,5966,258,634,0,3,258,631,200,436,729,903,1632,250,199,193,273,942,716,14.4106280193237,0.406940063091483,0,0.408874801901743,0.458715596330275,1.72946859903382,FALSE,3,9
"Michael Stewart",311,45,3450,251,568,0,0,251,568,134,255,357,579,936,88,58,288,145,591,636,11.0932475884244,0.441901408450704,NA,0.441901408450704,0.525490196078431,2.04501607717042,FALSE,3,8
"Mike Brown",626,112,10961,1126,2476,1,8,1125,2468,877,1271,934,1828,2762,424,253,169,643,1372,3130,17.5095846645367,0.454765751211632,0.125,0.455834683954619,0.690007867820614,5,FALSE,3,11
"Mike Gminski",1128,NA,29524,5106,11084,8,65,5098,11019,3028,3570,2535,5415,7950,1446,624,1179,1643,1872,13248,26.1737588652482,0.460664020209311,0.123076923076923,0.462655413376894,0.848179271708683,11.7446808510638,FALSE,3,14
"Mike Smrek",209,31,1985,220,516,0,2,220,514,138,226,153,295,448,53,40,153,141,444,578,9.49760765550239,0.426356589147287,0,0.428015564202335,0.610619469026549,2.76555023923445,FALSE,3,7
"Mike Sweetney",233,73,3610,564,1164,0,2,564,1162,388,563,400,645,1045,145,73,107,277,569,1516,15.4935622317597,0.484536082474227,0,0.485370051635112,0.689165186500888,6.50643776824034,FALSE,3,4
"Mikki Moore",674,201,11897,1438,2622,2,13,1436,2609,803,1071,888,1658,2546,484,203,342,609,1821,3681,17.6513353115727,0.548436308161709,0.153846153846154,0.550402453047145,0.749766573295985,5.46142433234421,FALSE,3,13
"Nazr Mohammed",1377,525,23277,3619,7358,0,12,3619,7346,1527,2396,2682,4255,6937,559,649,928,1358,3114,8765,16.9041394335512,0.491845610220169,0,0.492649060713313,0.637312186978297,6.36528685548293,FALSE,3,18
"Nenad Krstić",490,440,12118,1955,3945,2,14,1953,3931,873,1187,896,1700,2596,373,188,311,553,1435,4785,24.730612244898,0.495564005069708,0.142857142857143,0.496820147545154,0.735467565290649,9.76530612244898,FALSE,3,7
"Nikola Peković",271,194,6744,1314,2537,0,0,1314,2537,777,1023,803,1004,1807,199,140,151,414,632,3405,24.8856088560886,0.51793456838786,NA,0.51793456838786,0.759530791788856,12.5645756457565,FALSE,3,6
"Obinna Ekezie",176,32,1797,197,471,0,1,197,470,217,303,177,284,461,40,43,32,109,302,611,10.2102272727273,0.418259023354565,0,0.419148936170213,0.716171617161716,3.47159090909091,FALSE,3,4
"Olden Polynice",1205,753,29378,4219,8263,5,29,4214,8234,1389,2584,3249,5223,8472,827,601,750,1336,3216,9832,24.3800829875519,0.510589374319255,0.172413793103448,0.511780422637843,0.537538699690402,8.15933609958506,FALSE,3,15
"Oleksiy Pecherov",111,5,1044,160,414,45,155,115,259,73,92,88,178,266,20,21,22,59,119,438,9.4054054054054,0.386473429951691,0.290322580645161,0.444015444015444,0.793478260869565,3.94594594594595,FALSE,3,3
"Oliver Miller",554,204,12490,1659,3112,5,45,1654,3067,596,937,1045,2154,3199,1148,502,821,1011,1641,3919,22.5451263537906,0.533097686375321,0.111111111111111,0.539289207694816,0.63607257203842,7.07400722021661,FALSE,3,9
"Othella Harrington",783,308,15739,2268,4508,0,14,2268,4494,1341,1809,1226,2292,3518,499,219,331,1093,2105,5877,20.1008939974457,0.503105590062112,0,0.504672897196262,0.741293532338308,7.50574712643678,FALSE,3,12
"Otis Thorpe",1401,1090,44115,7551,13898,3,76,7548,13822,4184,6133,3799,7666,11465,3064,929,559,3058,4608,19289,31.4882226980728,0.543315584976256,0.0394736842105263,0.546085949934886,0.682210989727703,13.768022840828,FALSE,3,17
"P.J. Brown",1089,990,33823,3852,8365,8,59,3844,8306,2158,2718,3002,5407,8409,1661,912,1116,1342,3218,9870,31.058769513315,0.460490137477585,0.135593220338983,0.46279797736576,0.793966151582046,9.0633608815427,FALSE,3,15
"Pat Burke",127,8,1293,199,488,9,36,190,452,61,92,90,176,266,44,28,40,87,180,468,10.1811023622047,0.407786885245902,0.25,0.420353982300885,0.66304347826087,3.68503937007874,FALSE,3,3
"Patrick Ewing",1190,1122,40613,9702,19246,19,127,9683,19119,5395,7293,2753,8856,11609,2217,1136,2895,3538,4035,24818,34.1285714285714,0.504104749038761,0.149606299212598,0.50645954286312,0.739750445632799,20.855462184874,TRUE,3,17
"Patrick O'Bryant",129,6,779,124,244,0,5,124,239,39,68,45,148,193,36,24,59,64,187,287,6.03875968992248,0.508196721311475,0,0.518828451882845,0.573529411764706,2.22480620155039,FALSE,3,4
"Pero Antić",113,29,1962,231,590,108,344,123,246,138,189,115,283,398,107,37,26,104,258,708,17.3628318584071,0.391525423728814,0.313953488372093,0.5,0.73015873015873,6.26548672566372,FALSE,3,2
"Pervis Ellison",474,245,11593,1826,3579,1,20,1825,3559,841,1221,1087,2083,3170,691,293,752,798,1493,4494,24.457805907173,0.510198379435597,0.05,0.512784490025288,0.688779688779689,9.48101265822785,FALSE,3,11
"Pétur Guðmundsson",150,20,2060,251,508,1,2,250,506,190,252,166,397,563,153,35,96,195,400,693,13.7333333333333,0.494094488188976,0.5,0.494071146245059,0.753968253968254,4.62,FALSE,3,4
"Predrag Drobnjak",278,96,5542,903,2125,66,194,837,1931,315,394,313,660,973,225,132,117,242,512,2187,19.9352517985612,0.424941176470588,0.34020618556701,0.433454168824443,0.799492385786802,7.86690647482014,FALSE,3,4
"Primož Brezec",413,232,6762,1065,2154,1,6,1064,2148,452,655,605,828,1433,191,73,144,300,832,2583,16.3728813559322,0.494428969359331,0.166666666666667,0.495344506517691,0.690076335877863,6.25423728813559,FALSE,3,8
"Raef LaFrentz",641,514,17000,2648,5701,582,1583,2066,4118,863,1217,1170,2832,4002,695,331,1132,605,2144,6741,26.5210608424337,0.464479915804245,0.367656348704991,0.501699854298203,0.709120788824979,10.5163806552262,FALSE,3,10
"Rafael Araújo",139,75,1585,156,385,1,4,155,381,76,112,124,271,395,41,51,16,111,300,389,11.4028776978417,0.405194805194805,0.25,0.406824146981627,0.678571428571429,2.79856115107914,FALSE,3,3
"Ralph Sampson",504,407,15254,3223,6694,12,69,3211,6625,1330,1982,1314,3159,4473,1160,431,840,1534,1754,7788,30.265873015873,0.481475948610696,0.173913043478261,0.484679245283019,0.671039354187689,15.452380952381,TRUE,3,9
"Randy Breuer",762,340,14378,2196,4756,0,5,2196,4751,929,1471,1215,2188,3403,713,347,858,772,1660,5321,18.8687664041995,0.461732548359966,0,0.462218480319933,0.631543167912984,6.98293963254593,FALSE,3,11
"Rasheed Wallace",1177,1022,38633,6745,14503,1168,3476,5577,11027,2436,3374,1680,6183,7863,2150,1151,1582,1812,3449,17094,32.8232795242141,0.465076191132869,0.336018411967779,0.50575859254557,0.721991701244813,14.5233644859813,FALSE,3,16
"Rasho Nesterović",811,595,17983,2570,5121,1,13,2569,5108,378,646,1513,2630,4143,836,330,934,748,2187,5519,22.173859432799,0.501855106424526,0.0769230769230769,0.502936570086139,0.585139318885449,6.80517879161529,FALSE,3,12
"Richard Anderson",481,33,7352,1080,2645,196,595,884,2050,352,463,548,1173,1721,723,276,110,423,828,2708,15.2848232848233,0.408317580340265,0.329411764705882,0.431219512195122,0.760259179265659,5.62993762993763,FALSE,3,6
"Rick Mahorn",1117,NA,25779,3098,6286,5,38,3093,6248,1562,2218,1814,5143,6957,1082,633,1007,1456,3499,7763,23.0787824529991,0.492841234489341,0.131578947368421,0.495038412291933,0.704238052299369,6.94986571172784,FALSE,3,18
"Rickey Brown",416,NA,5535,781,1671,0,6,781,1665,319,486,513,953,1466,144,108,140,383,968,1881,13.3052884615385,0.467384799521245,0,0.469069069069069,0.656378600823045,4.52163461538461,FALSE,3,5
"Rik Smits",867,792,23100,5301,10461,3,26,5298,10435,2266,2932,1531,3746,5277,1215,372,1111,1579,3011,12871,26.643598615917,0.50673931746487,0.115384615384615,0.507714422616195,0.772851296043656,14.8454440599769,FALSE,3,12
"Robert Sacre",189,35,2745,318,729,0,1,318,728,151,225,212,381,593,126,56,110,102,336,787,14.5238095238095,0.436213991769547,0,0.436813186813187,0.671111111111111,4.16402116402116,FALSE,3,4
"Robert Traylor",438,73,6243,841,1774,4,24,837,1750,399,691,671,969,1640,312,280,306,400,1079,2085,14.2534246575342,0.474069898534386,0.166666666666667,0.478285714285714,0.577424023154848,4.76027397260274,FALSE,3,7
"Ronny Turiaf",490,110,8299,875,1640,0,8,875,1632,510,804,540,1287,1827,628,195,610,372,1155,2260,16.9367346938776,0.533536585365854,0,0.536151960784314,0.634328358208955,4.61224489795918,FALSE,3,10
"Rony Seikaly",734,656,23031,3897,8119,6,34,3891,8085,2937,4293,2288,4529,6817,937,481,915,2059,2505,10737,31.3773841961853,0.479985219854662,0.176470588235294,0.48126159554731,0.684136967155835,14.6280653950954,FALSE,3,11
"Roy Hibbert",710,599,17071,2702,5788,6,24,2696,5764,1422,1877,1581,2744,4325,906,249,1192,1070,2167,6832,24.043661971831,0.46682791983414,0.25,0.467730742539903,0.757591901971231,9.6225352112676,FALSE,3,9
"Roy Tarpley",280,57,7476,1457,3014,6,34,1451,2980,613,824,964,1839,2803,292,317,329,557,950,3533,26.7,0.483410749834107,0.176470588235294,0.486912751677852,0.743932038834951,12.6178571428571,FALSE,3,6
"Ryan Hollins",639,99,7560,832,1434,0,1,832,1433,647,1019,584,833,1417,177,112,341,467,1255,2311,11.830985915493,0.580195258019526,0,0.580600139567341,0.634936211972522,3.61658841940532,FALSE,3,10
"Sam Bowie",511,349,14098,2127,4702,32,106,2095,4596,1278,1708,1192,2653,3845,1075,263,909,978,1553,5564,27.5890410958904,0.4523606975755,0.30188679245283,0.455831157528285,0.74824355971897,10.8884540117417,FALSE,3,10
"Sam Perkins",1365,819,38949,5879,12783,873,2419,5006,10364,3729,4597,2487,5703,8190,2131,1165,1015,1694,3402,16360,28.5340659340659,0.459907689900649,0.360892930963208,0.483018139714396,0.811181205133783,11.985347985348,FALSE,3,17
"Samaki Walker",445,143,7612,936,2026,1,9,935,2017,503,798,627,1462,2089,252,134,316,403,895,2376,17.1056179775281,0.461994076999013,0.111111111111111,0.463559742191373,0.630325814536341,5.33932584269663,FALSE,3,10
"Samardo Samuels",109,11,1722,237,532,0,4,237,528,164,251,148,218,366,45,38,41,115,231,638,15.7981651376147,0.445488721804511,0,0.448863636363636,0.653386454183267,5.85321100917431,FALSE,3,3
"Samuel Dalembert",886,694,21646,2810,5393,1,12,2809,5381,1193,1689,2289,4653,6942,465,437,1546,1271,2601,6814,24.431151241535,0.521045800111255,0.0833333333333333,0.522021929009478,0.706335109532268,7.69074492099323,FALSE,3,13
"Scot Pollard",506,99,8372,858,1738,0,2,858,1736,506,714,901,1450,2351,220,299,352,304,1178,2222,16.5454545454545,0.493670886075949,0,0.494239631336406,0.708683473389356,4.39130434782609,FALSE,3,11
"Scott Hastings",609,19,6125,597,1361,28,99,569,1262,462,576,439,889,1328,287,165,154,334,1071,1684,10.0574712643678,0.438648052902278,0.282828282828283,0.450871632329636,0.802083333333333,2.76518883415435,FALSE,3,11
"Scott Williams",796,287,12793,1684,3605,7,48,1677,3557,662,924,1322,2330,3652,449,416,439,565,2020,4037,16.071608040201,0.467128987517337,0.145833333333333,0.471464717458532,0.716450216450216,5.071608040201,FALSE,3,15
"Sean Marks",230,11,2275,259,578,5,25,254,553,115,173,158,343,501,50,33,87,116,342,638,9.89130434782609,0.448096885813149,0.2,0.459312839059675,0.664739884393064,2.77391304347826,FALSE,3,11
"Sean May",119,25,1868,324,708,3,13,321,695,170,228,155,326,481,115,53,47,134,236,821,15.6974789915966,0.457627118644068,0.230769230769231,0.461870503597122,0.745614035087719,6.89915966386555,FALSE,3,4
"Sean Rooks",869,237,15272,1908,4161,3,30,1905,4131,1422,2034,1048,2181,3229,707,292,551,906,1887,5241,17.5742232451093,0.458543619322278,0.1,0.461147421931736,0.699115044247788,6.03107019562716,FALSE,3,12
"Sean Williams",148,29,2085,243,470,0,1,243,469,135,210,196,301,497,52,51,170,130,342,621,14.0878378378378,0.517021276595745,0,0.518123667377399,0.642857142857143,4.19594594594595,FALSE,3,4
"Semih Erden",110,25,1523,163,296,0,0,163,296,99,161,94,214,308,49,40,53,84,268,425,13.8454545454545,0.550675675675676,NA,0.550675675675676,0.614906832298137,3.86363636363636,FALSE,3,2
"Shaquille O'Neal",1268,1258,43666,11661,20015,1,22,11660,19993,6105,11590,4375,9278,13653,3119,771,2820,3491,4374,29428,34.4369085173502,0.582613040219835,0.0454545454545455,0.583204121442505,0.526747195858499,23.2082018927445,TRUE,3,19
"Shareef Abdur-Rahim",915,760,31566,5935,12569,163,553,5772,12016,4379,5372,2058,4820,6878,2283,888,675,2320,2546,16412,34.4983606557377,0.472193491924576,0.294755877034358,0.480359520639148,0.815152643335815,17.9366120218579,FALSE,3,12
"Sharone Wright",260,153,5965,1025,2217,2,15,1023,2202,586,937,567,812,1379,156,112,252,464,725,2638,22.9423076923077,0.46233649075327,0.133333333333333,0.464577656675749,0.625400213447172,10.1461538461538,FALSE,3,4
"Shawn Bradley",984,622,24148,3506,7713,5,51,3501,7662,1640,2321,2185,4332,6517,688,621,2655,1372,3090,8657,24.5406504065041,0.454557241021652,0.0980392156862745,0.456930305403289,0.706591986212839,8.79776422764228,FALSE,3,12
"Shawn Kemp",1051,728,29293,5505,11278,33,119,5472,11159,4304,5805,3026,5808,8834,1704,1185,1279,2766,3826,15347,27.871550903901,0.488118460719986,0.277310924369748,0.490366520297518,0.741429801894918,14.6022835394862,FALSE,3,14
"Shawnelle Scott",105,11,634,78,168,0,0,78,168,33,71,104,124,228,20,14,23,36,123,189,6.03809523809524,0.464285714285714,NA,0.464285714285714,0.464788732394366,1.8,FALSE,3,4
"Shelden Williams",529,142,7785,855,1865,2,13,853,1852,611,832,739,1454,2193,226,246,229,416,1033,2323,14.7164461247637,0.458445040214477,0.153846153846154,0.460583153347732,0.734375,4.39130434782609,FALSE,3,6
"Sidney Green",718,242,13576,2027,4475,1,29,2026,4446,1118,1512,1332,2914,4246,659,375,228,1058,1834,5173,18.908077994429,0.452960893854749,0.0344827586206897,0.455690508322087,0.739417989417989,7.20473537604457,FALSE,3,10
"Solomon Jones",302,13,3384,325,706,1,9,324,697,255,352,289,423,712,108,67,165,179,597,906,11.205298013245,0.460339943342776,0.111111111111111,0.464849354375897,0.724431818181818,3,FALSE,3,8
"Spencer Hawes",818,447,18808,2988,6523,512,1415,2476,5108,834,1141,1160,3584,4744,1592,323,776,1193,2023,7322,22.9926650366748,0.458071439521692,0.361837455830389,0.484729835552075,0.730937773882559,8.95110024449878,FALSE,3,10
"Stacey King",498,93,8562,1228,2603,4,19,1224,2584,768,1095,698,1030,1728,446,206,253,616,1041,3228,17.1927710843373,0.471763349980791,0.210526315789474,0.473684210526316,0.701369863013699,6.48192771084337,FALSE,3,8
"Stanislav Medvedenko",263,58,3340,590,1311,2,13,588,1298,208,281,335,409,744,136,88,42,159,518,1390,12.6996197718631,0.450038138825324,0.153846153846154,0.453004622496148,0.740213523131673,5.2851711026616,FALSE,3,7
"Stanley Roberts",300,178,5869,1059,2124,0,2,1059,2122,437,850,506,1043,1549,189,110,385,370,1060,2555,19.5633333333333,0.498587570621469,0,0.499057492931197,0.514117647058824,8.51666666666667,FALSE,3,8
"Steve Hayes",247,3,2783,287,594,0,1,287,593,111,211,242,401,643,113,36,122,118,509,685,11.2672064777328,0.483164983164983,0,0.48397976391231,0.5260663507109,2.77327935222672,FALSE,3,5
"Steve Johnson",732,348,15364,3191,5597,0,4,3191,5593,1849,2944,1374,2547,3921,875,330,604,1672,2772,8231,20.9890710382514,0.57012685367161,0,0.57053459681745,0.628057065217391,11.2445355191257,FALSE,3,10
"Steve Scheffler",185,8,979,127,226,1,5,126,221,97,128,91,103,194,26,33,9,35,141,352,5.29189189189189,0.561946902654867,0.2,0.570135746606335,0.7578125,1.9027027027027,FALSE,3,7
"Steve Stipanovich",403,365,12591,2015,4160,10,56,2005,4104,1283,1611,771,2360,3131,938,415,380,777,1435,5323,31.24317617866,0.484375,0.178571428571429,0.4885477582846,0.796399751707014,13.2084367245658,FALSE,3,5
"Steven Hunter",400,130,5993,735,1313,0,1,735,1312,347,715,482,782,1264,79,49,422,249,656,1817,14.9825,0.55978674790556,0,0.560213414634146,0.485314685314685,4.5425,FALSE,3,8
"Stojko Vranković",170,73,2050,197,413,0,0,197,413,79,132,155,361,516,59,22,179,132,318,473,12.0588235294118,0.476997578692494,NA,0.476997578692494,0.598484848484849,2.78235294117647,FALSE,3,5
"Stromile Swift",622,101,11833,1872,3944,3,30,1869,3914,1240,1785,965,1815,2780,304,373,745,757,1510,4987,19.024115755627,0.474645030425964,0.1,0.47751660705161,0.694677871148459,8.01768488745981,FALSE,3,9
"Stuart Gray",444,6,4017,380,857,0,12,380,845,262,394,349,816,1165,167,79,159,267,735,1022,9.0472972972973,0.44340723453909,0,0.449704142011834,0.66497461928934,2.3018018018018,FALSE,3,7
"Terry Davis",480,275,10369,1202,2545,3,19,1199,2526,654,1081,1106,1781,2887,273,183,149,518,1176,3061,21.6020833333333,0.47229862475442,0.157894736842105,0.474663499604117,0.604995374653099,6.37708333333333,FALSE,3,10
"Theo Ratliff",1052,721,26855,2890,5834,0,3,2890,5831,1799,2556,2050,3953,6003,632,516,2631,1299,3026,7579,25.527566539924,0.495371957490573,0,0.495626822157434,0.703834115805947,7.20437262357414,FALSE,3,16
"Tiago Splitter",355,153,6812,1073,1932,2,14,1071,1918,668,958,576,1203,1779,423,198,209,384,685,2816,19.1887323943662,0.555383022774327,0.142857142857143,0.558394160583942,0.697286012526096,7.93239436619718,FALSE,3,7
"Tim Duncan",1392,1389,47368,10285,20334,30,168,10255,20166,5896,8468,3859,11232,15091,4225,1025,3020,3381,3304,26496,34.0287356321839,0.50580308842333,0.178571428571429,0.50852920757711,0.696268304204062,19.0344827586207,TRUE,3,19
"Tim McCormick",553,265,12504,1895,3541,1,18,1894,3523,1080,1545,923,1910,2833,609,171,210,730,1490,4871,22.6112115732369,0.535159559446484,0.0555555555555556,0.53760999148453,0.699029126213592,8.80831826401447,FALSE,3,8
"Tim Perry",511,226,9690,1344,2775,96,297,1248,2478,570,881,748,1211,1959,444,225,427,501,816,3354,18.9628180039139,0.484324324324324,0.323232323232323,0.50363196125908,0.646992054483541,6.56360078277886,FALSE,3,8
"Tod Murphy",200,81,4138,402,884,18,62,384,822,242,358,344,607,951,187,115,88,113,392,1064,20.69,0.454751131221719,0.290322580645161,0.467153284671533,0.675977653631285,5.32,FALSE,3,5
"Todd Fuller",225,23,2500,317,752,0,4,317,748,201,301,240,434,674,46,34,60,146,351,835,11.1111111111111,0.421542553191489,0,0.42379679144385,0.667774086378738,3.71111111111111,FALSE,3,5
"Todd MacCulloch",223,105,3439,568,1049,0,0,568,1049,233,363,340,548,888,121,61,177,154,478,1369,15.4215246636771,0.541468064823642,NA,0.541468064823642,0.641873278236915,6.1390134529148,FALSE,3,4
"Tony Battie",910,436,19127,2313,4771,14,83,2299,4688,850,1226,1494,3152,4646,580,446,780,767,2362,5490,21.0186813186813,0.484804024313561,0.168674698795181,0.490401023890785,0.693311582381729,6.03296703296703,FALSE,3,14
"Tony Farmer",101,11,1368,144,365,10,53,134,312,234,304,134,193,327,79,76,20,91,190,532,13.5445544554455,0.394520547945205,0.188679245283019,0.429487179487179,0.769736842105263,5.26732673267327,FALSE,3,2
"Tony Massenburg",755,261,13844,1862,3941,1,14,1861,3927,1081,1535,1188,2153,3341,296,290,343,767,1768,4806,18.3364238410596,0.47246891651865,0.0714285714285714,0.473898650369239,0.704234527687296,6.36556291390728,FALSE,3,13
"Travis Knight",371,58,4566,522,1192,15,58,507,1134,217,312,441,719,1160,224,136,220,244,805,1276,12.3072776280323,0.437919463087248,0.258620689655172,0.447089947089947,0.69551282051282,3.43935309973046,FALSE,3,7
"Tyrone Hill",895,676,24843,3085,6217,0,13,3085,6204,1999,3131,2637,4895,7532,723,694,421,1371,3210,8169,27.7575418994413,0.496220041820814,0,0.497259832366215,0.638454167997445,9.12737430167598,FALSE,3,14
"Tyrus Thomas",456,132,9152,1341,3040,8,37,1333,3003,911,1255,631,1642,2273,403,391,610,619,1118,3601,20.0701754385965,0.441118421052632,0.216216216216216,0.443889443889444,0.72589641434263,7.8969298245614,FALSE,3,8
"Uwe Blab",282,67,2497,224,525,0,0,224,525,155,259,157,364,521,127,20,107,176,446,603,8.85460992907801,0.426666666666667,NA,0.426666666666667,0.598455598455598,2.13829787234043,FALSE,3,5
"Victor Alexander",286,155,5755,1101,2126,18,63,1083,2063,322,508,446,938,1384,257,135,177,378,713,2542,20.1223776223776,0.517873941674506,0.285714285714286,0.524963645176927,0.633858267716535,8.88811188811189,FALSE,3,5
"Vin Baker",872,637,27254,4913,10149,40,185,4873,9964,2539,3961,2392,3794,6186,1585,613,834,1850,2758,12405,31.2545871559633,0.484087102177554,0.216216216216216,0.489060618225612,0.6409997475385,14.2259174311927,FALSE,3,13
"Vitaly Potapenko",693,245,13355,1880,3907,1,7,1879,3900,817,1203,1208,1913,3121,502,295,247,902,1756,4578,19.2712842712843,0.4811876119785,0.142857142857143,0.481794871794872,0.679135494596841,6.60606060606061,FALSE,3,11
"Vlade Divac",1134,979,33838,5205,10510,100,426,5105,10084,2888,4176,2881,6445,9326,3541,1288,1631,2470,3609,13398,29.8395061728395,0.495242626070409,0.234741784037559,0.506247520825069,0.691570881226054,11.8148148148148,TRUE,3,16
"Vladimir Stepania",270,19,3726,455,1071,2,15,453,1056,206,384,444,736,1180,94,110,144,213,482,1118,13.8,0.42483660130719,0.133333333333333,0.428977272727273,0.536458333333333,4.14074074074074,FALSE,3,6
"Wallace Bryant",119,51,1613,149,377,0,0,149,377,66,115,145,282,427,127,40,45,80,234,364,13.5546218487395,0.395225464190981,NA,0.395225464190981,0.573913043478261,3.05882352941176,FALSE,3,3
"Wang Zhizhi",153,1,1370,230,557,74,196,156,361,117,157,60,189,249,41,28,40,74,168,651,8.95424836601307,0.412926391382406,0.377551020408163,0.43213296398892,0.745222929936306,4.25490196078431,FALSE,3,5
"Will Perdue",792,223,12360,1517,2943,1,15,1516,2928,705,1222,1420,2498,3918,595,226,527,813,1589,3740,15.6060606060606,0.515460414542983,0.0666666666666667,0.51775956284153,0.576923076923077,4.72222222222222,FALSE,3,13
"William Bedford",238,30,2514,405,974,7,22,398,952,147,243,201,372,573,109,37,126,173,358,964,10.563025210084,0.415811088295688,0.318181818181818,0.418067226890756,0.604938271604938,4.05042016806723,FALSE,3,6
"Yao Ming",486,476,15818,3380,6445,2,10,3378,6435,2485,2984,1233,3261,4494,769,189,920,1311,1596,9247,32.5473251028807,0.524437548487199,0.2,0.524941724941725,0.832774798927614,19.0267489711934,TRUE,3,8
"Yinka Dare",110,25,1002,86,217,0,0,86,217,61,107,101,180,281,4,12,70,96,179,233,9.10909090909091,0.3963133640553,NA,0.3963133640553,0.570093457943925,2.11818181818182,FALSE,3,4
"Žan Tabak",304,104,4591,679,1366,0,4,679,1362,182,364,409,686,1095,213,85,164,330,740,1540,15.1019736842105,0.497071742313324,0,0.498531571218796,0.5,5.06578947368421,FALSE,3,6
"Željko Rebrača",239,24,3553,522,1003,0,0,522,1003,323,409,219,527,746,94,62,171,220,564,1367,14.8661087866109,0.520438683948156,NA,0.520438683948156,0.789731051344743,5.71966527196653,FALSE,3,5
"Zendon Hamilton",146,15,1609,183,414,0,0,183,414,245,371,187,288,475,33,43,28,114,220,611,11.0205479452055,0.442028985507246,NA,0.442028985507246,0.660377358490566,4.18493150684932,FALSE,3,6
"Zydrunas Ilgauskas",843,724,22965,4207,8842,31,100,4176,8742,2531,3243,2444,3747,6191,955,421,1327,1509,2776,10976,27.2419928825623,0.475797330920606,0.31,0.477693891557996,0.780450200431699,13.0201660735469,FALSE,3,13
