"player","g","gs","mp","fg","fga","x3p","x3pa","x2p","x2pa","ft","fta","orb","drb","trb","ast","stl","blk","tov","pf","pts","mpg","fg_percent","x3p_percent","x2p_percent","ft_percent","pts_per_game","hof","pos","years"
"A.C. Green",1361,905,39044,4778,9686,125,509,4653,9177,3247,4447,3576,6553,10129,1469,1103,562,1508,2581,12928,28.6877296105805,0.493289283501962,0.245579567779961,0.507028440666885,0.73015516078255,9.49889786921381,FALSE,2,16
"Aaron McKie",957,330,22594,2554,5923,441,1275,2113,4648,1087,1389,580,2459,3039,2462,1090,199,1225,1882,6636,23.6091954022989,0.431200405200068,0.345882352941176,0.45460413080895,0.782577393808495,6.93416927899687,FALSE,2,13
"Adam Morrison",213,33,3989,547,1475,156,471,391,1004,159,223,100,322,422,263,49,16,204,350,1409,18.7276995305164,0.370847457627119,0.331210191082803,0.389442231075697,0.713004484304933,6.6150234741784,FALSE,2,3
"Adrian Branch",130,7,1429,331,727,9,39,322,688,163,219,114,139,253,96,83,17,125,193,834,10.9923076923077,0.455295735900963,0.230769230769231,0.468023255813953,0.744292237442922,6.41538461538462,FALSE,2,4
"Adrian Caldwell",242,1,2172,204,430,0,5,204,425,83,187,238,425,663,45,72,49,154,357,491,8.97520661157025,0.474418604651163,0,0.48,0.443850267379679,2.02892561983471,FALSE,2,6
"Adrian Griffin",512,181,8304,815,1870,50,180,765,1690,304,401,535,1036,1571,680,453,61,352,906,1984,16.21875,0.435828877005348,0.277777777777778,0.452662721893491,0.758104738154613,3.875,FALSE,2,9
"Al Thornton",442,236,11736,1893,4136,93,323,1800,3813,976,1307,564,1176,1740,505,265,199,590,1120,4855,26.552036199095,0.457688588007737,0.287925696594427,0.4720692368214,0.746748278500383,10.9841628959276,FALSE,2,4
"Al Wood",465,251,10869,2159,4635,43,214,2116,4421,995,1262,510,886,1396,800,341,168,640,1052,5356,23.3741935483871,0.465803667745415,0.200934579439252,0.478624745532685,0.788431061806656,11.5182795698925,FALSE,2,6
"Alaa Abdelnaby",385,105,5017,983,1940,0,6,983,1934,333,472,446,851,1297,125,111,107,389,777,2299,13.0311688311688,0.506701030927835,0,0.508273009307135,0.705508474576271,5.97142857142857,FALSE,2,5
"Alan Anderson",330,66,6793,843,2084,331,963,512,1121,404,495,151,563,714,371,182,31,290,602,2421,20.5848484848485,0.404510556621881,0.343717549325026,0.456735057983943,0.816161616161616,7.33636363636364,FALSE,2,8
"Albert King",534,326,12836,2709,5875,56,209,2653,5666,996,1259,760,1502,2262,1171,452,196,1151,1612,6470,24.0374531835206,0.461106382978723,0.267942583732057,0.468231556653724,0.791104050833995,12.1161048689139,FALSE,2,9
"Alexander Johnson",102,25,1302,152,294,0,0,152,294,135,201,82,193,275,30,38,45,89,217,439,12.7647058823529,0.517006802721088,NA,0.517006802721088,0.671641791044776,4.30392156862745,FALSE,2,2
"Alonzo Gee",527,249,10851,1209,2759,216,658,993,2101,692,920,488,1148,1636,504,454,126,535,944,3326,20.5901328273245,0.438202247191011,0.328267477203647,0.472632079961923,0.752173913043478,6.3111954459203,FALSE,2,8
"Andrei Kirilenko",797,546,23916,3146,6637,367,1185,2779,5452,2772,3675,1400,2952,4352,2169,1097,1461,1518,1605,9431,30.0075282308657,0.474009341569986,0.309704641350211,0.509721203228173,0.754285714285714,11.8331242158093,FALSE,2,13
"Andr√©s Nocioni",590,221,14004,2231,5179,711,1885,1520,3294,1109,1389,408,2248,2656,716,254,261,837,1655,6282,23.735593220339,0.430778142498552,0.377188328912467,0.461445051608986,0.798416126709863,10.6474576271186,FALSE,2,8
"Andrew Nicholson",323,36,4422,751,1628,92,298,659,1330,206,269,203,715,918,136,90,101,229,513,1800,13.6904024767802,0.461302211302211,0.308724832214765,0.495488721804511,0.765799256505576,5.57275541795666,FALSE,2,5
"Anfernee Hardaway",780,571,25806,4274,9410,533,1670,3741,7740,2302,2969,1044,2389,3433,3701,1195,332,1893,1708,11383,33.0846153846154,0.454197662061637,0.319161676646707,0.483333333333333,0.775345234085551,14.5935897435897,FALSE,2,14
"Ansu Sesay",127,6,1301,161,371,8,29,153,342,71,111,102,121,223,62,38,30,58,162,401,10.244094488189,0.433962264150943,0.275862068965517,0.447368421052632,0.63963963963964,3.15748031496063,FALSE,2,4
"Antawn Jamison",1149,928,40044,8157,18060,1248,3612,6909,14448,3715,5160,2693,6019,8712,1845,1119,442,1805,2759,21277,34.8511749347258,0.451661129568106,0.345514950166113,0.478197674418605,0.719961240310077,18.5178416013925,FALSE,2,16
"Anthony Avent",426,196,8100,964,2417,0,2,964,2415,419,604,704,1218,1922,343,199,242,501,971,2347,19.0140845070423,0.398841539098055,0,0.399171842650104,0.693708609271523,5.5093896713615,FALSE,2,6
"Anthony Bennett",151,4,1905,251,641,36,138,215,503,120,179,132,340,472,77,58,27,99,206,658,12.6158940397351,0.391575663026521,0.260869565217391,0.427435387673956,0.670391061452514,4.35761589403973,FALSE,2,4
"Anthony Bonner",318,120,7372,881,1881,2,16,879,1865,435,737,708,1018,1726,442,346,84,450,784,2199,23.1823899371069,0.468367889420521,0.125,0.471313672922252,0.59023066485753,6.91509433962264,FALSE,2,6
"Anthony Cook",141,25,1702,192,432,0,7,192,425,96,189,192,292,484,38,46,105,78,162,480,12.0709219858156,0.444444444444444,0,0.451764705882353,0.507936507936508,3.40425531914894,FALSE,2,4
"Anthony Frederick",147,29,1640,291,663,6,22,285,641,130,186,137,143,280,135,76,45,132,200,718,11.156462585034,0.438914027149321,0.272727272727273,0.444617784711388,0.698924731182796,4.8843537414966,FALSE,2,3
"Anthony Jones",262,8,2758,396,996,26,85,370,911,175,231,141,205,346,209,138,60,150,275,993,10.5267175572519,0.397590361445783,0.305882352941176,0.406147091108672,0.757575757575758,3.79007633587786,FALSE,2,3
"Anthony Miller",185,15,1648,198,388,2,8,196,380,114,198,185,305,490,66,58,26,91,245,512,8.90810810810811,0.510309278350515,0.25,0.515789473684211,0.575757575757576,2.76756756756757,FALSE,2,8
"Anthony Parker",494,423,13752,1661,3744,596,1474,1065,2270,560,705,241,1333,1574,1129,439,85,495,792,4478,27.8380566801619,0.443643162393162,0.404341926729986,0.469162995594714,0.794326241134752,9.06477732793522,FALSE,2,9
"Antoine Walker",970,784,34486,6666,16087,1496,4605,5170,11482,2292,3676,2076,5510,7586,3435,1174,527,2757,2733,17120,35.5525773195876,0.414371853049046,0.32486427795874,0.450269987807002,0.623503808487486,17.6494845360825,FALSE,2,12
"Antoine Wright",353,106,6946,753,1828,187,620,566,1208,271,401,197,631,828,375,167,93,277,725,1964,19.6770538243626,0.411925601750547,0.301612903225806,0.468543046357616,0.675810473815461,5.56373937677054,FALSE,2,6
"Antonio Harvey",242,47,2775,313,789,1,5,312,784,130,263,224,409,633,73,81,177,152,331,757,11.4669421487603,0.396704689480355,0.2,0.397959183673469,0.494296577946768,3.12809917355372,FALSE,2,8
"Antonio Lang",153,1,1433,122,272,0,8,122,264,91,126,80,135,215,52,59,47,91,215,335,9.36601307189543,0.448529411764706,0,0.462121212121212,0.722222222222222,2.18954248366013,FALSE,2,6
"Armen Gilliam",1080,668,31491,5809,11836,0,21,5809,11815,3595,4644,2548,5050,7598,1292,814,711,2079,2406,15213,29.1583333333333,0.490790807705306,0,0.491663140076174,0.77411714039621,14.0861111111111,FALSE,2,13
"Art Long",124,27,1431,176,398,4,6,172,392,49,107,151,228,379,54,32,53,105,255,405,11.5403225806452,0.442211055276382,0.666666666666667,0.438775510204082,0.457943925233645,3.26612903225806,FALSE,2,3
"Austin Croshere",673,88,11580,1505,3698,434,1277,1071,2421,1071,1248,711,1972,2683,636,246,217,662,1099,4515,17.2065378900446,0.406976744186047,0.339859044635865,0.442379182156134,0.858173076923077,6.70876671619614,FALSE,2,12
"Austin Daye",404,34,5300,731,1827,265,741,466,1086,237,307,174,815,989,279,146,148,261,619,1964,13.1188118811881,0.400109469074986,0.357624831309042,0.429097605893186,0.771986970684039,4.86138613861386,FALSE,2,6
"Ben McDonald",176,75,3692,463,989,10,44,453,945,125,172,215,353,568,236,77,17,149,487,1061,20.9772727272727,0.468149646107179,0.227272727272727,0.479365079365079,0.726744186046512,6.02840909090909,FALSE,2,4
"Bernard Robinson",159,19,2187,231,570,5,33,226,537,170,214,96,267,363,145,126,18,126,247,637,13.7547169811321,0.405263157894737,0.151515151515152,0.420856610800745,0.794392523364486,4.0062893081761,FALSE,2,3
"Bernard Thompson",204,29,2935,410,934,0,17,410,917,258,327,164,188,352,266,127,27,181,391,1078,14.3872549019608,0.438972162740899,0,0.44711014176663,0.788990825688073,5.2843137254902,FALSE,2,5
"Bill Curley",195,13,2115,211,469,3,12,208,457,108,149,163,214,377,77,81,57,112,451,533,10.8461538461538,0.449893390191898,0.25,0.455142231947484,0.724832214765101,2.73333333333333,FALSE,2,5
"Bill Hanzlik",748,NA,15534,1836,4232,46,216,1790,4016,1696,2171,691,1367,2058,2058,727,205,1090,2222,5414,20.7673796791444,0.433837429111531,0.212962962962963,0.445717131474104,0.781206817134961,7.2379679144385,FALSE,2,10
"Billy Owens",724,537,20906,3346,7000,98,334,3248,6666,1418,2257,1691,3037,4728,2005,651,380,1559,2119,8208,28.8756906077348,0.478,0.293413173652695,0.487248724872487,0.628267611874169,11.3370165745856,FALSE,2,10
"Billy Thompson",300,149,6697,1074,2128,2,13,1072,2115,416,617,670,945,1615,514,158,272,529,817,2566,22.3233333333333,0.504699248120301,0.153846153846154,0.506855791962175,0.674230145867099,8.55333333333333,FALSE,2,6
"Blue Edwards",771,459,19521,3202,6755,326,983,2876,5772,1314,1680,748,1758,2506,1486,771,313,1268,2066,8044,25.3190661478599,0.474019245003701,0.331637843336724,0.498267498267498,0.782142857142857,10.4332036316472,FALSE,2,10
"Bob McCann",178,7,2385,296,618,1,5,295,613,146,253,154,314,468,104,80,79,134,349,739,13.3988764044944,0.478964401294498,0.2,0.481239804241436,0.577075098814229,4.15168539325843,FALSE,2,5
"Bob Thornton",331,32,3979,385,850,2,11,383,839,236,417,313,511,824,114,85,38,245,681,1008,12.0211480362538,0.452941176470588,0.181818181818182,0.456495828367104,0.565947242206235,3.04531722054381,FALSE,2,8
"Bobby Simmons",466,228,11513,1551,3552,378,955,1173,2597,709,862,559,1232,1791,710,396,83,522,1153,4189,24.706008583691,0.436655405405405,0.395811518324607,0.451675009626492,0.822505800464037,8.98927038626609,FALSE,2,10
"Bonzi Wells",736,309,18567,3429,7530,257,802,3172,6728,1580,2270,962,2366,3328,1485,935,243,1479,1880,8695,25.226902173913,0.455378486055777,0.320448877805486,0.471462544589774,0.696035242290749,11.8138586956522,FALSE,2,10
"Boris Diaw",1202,658,32946,4409,8946,581,1693,3828,7253,1177,1652,1446,3900,5346,4222,743,588,2224,2596,10576,27.4093178036606,0.492845964676951,0.343177790903721,0.527781607610644,0.712469733656174,8.79866888519135,FALSE,2,14
"Bo≈°tjan Nachbar",424,44,7471,959,2401,419,1134,540,1267,566,721,158,920,1078,384,180,105,377,946,2903,17.6202830188679,0.399416909620991,0.369488536155203,0.42620363062352,0.78502080443828,6.84669811320755,FALSE,2,6
"Brad Lohaus",868,190,14133,2128,4831,491,1356,1637,3475,538,727,672,1915,2587,992,405,664,761,1742,5285,16.2822580645161,0.440488511695301,0.362094395280236,0.471079136690647,0.740027510316369,6.08870967741935,FALSE,2,11
"Brad Sellers",457,123,7854,1129,2522,6,35,1123,2487,509,642,467,686,1153,468,154,268,381,752,2773,17.1859956236324,0.447660586835845,0.171428571428571,0.451548049859268,0.792834890965732,6.06783369803063,FALSE,2,6
"Brandon Davies",105,12,1421,164,402,18,78,146,324,82,127,114,161,275,88,60,22,93,210,428,13.5333333333333,0.407960199004975,0.230769230769231,0.450617283950617,0.645669291338583,4.07619047619048,FALSE,2,2
"Brandon Rush",481,163,10564,1220,2861,522,1300,698,1561,288,408,187,1226,1413,468,222,262,400,620,3250,21.962577962578,0.426424327158336,0.401538461538462,0.447149263292761,0.705882352941177,6.75675675675676,FALSE,2,9
"Brent Barry",970,485,25243,3109,6807,1485,3671,1624,3136,1416,1715,479,2472,2951,3045,1019,280,1393,1872,9119,26.0237113402062,0.456735713236374,0.404521928629801,0.517857142857143,0.825655976676385,9.40103092783505,FALSE,2,14
"Brian Cardinal",456,37,6477,664,1628,243,653,421,975,537,624,286,764,1050,465,295,69,330,890,2108,14.2039473684211,0.407862407862408,0.372128637059724,0.431794871794872,0.860576923076923,4.62280701754386,FALSE,2,12
"Brian Evans",190,2,2135,280,734,70,208,210,526,100,122,111,209,320,147,69,34,82,224,730,11.2368421052632,0.381471389645777,0.336538461538462,0.399239543726236,0.819672131147541,3.8421052631579,FALSE,2,3
"Bruce Bowen",942,646,24930,2017,4955,845,2140,1172,2815,607,1056,496,2028,2524,1123,735,351,665,2048,5486,26.4649681528662,0.407063572149344,0.394859813084112,0.416341030195382,0.574810606060606,5.82377919320594,FALSE,2,13
"Bryon Russell",841,392,19805,2274,5272,685,1856,1589,3416,1430,1906,752,2162,2914,1085,874,203,835,1984,6663,23.5493460166468,0.43133535660091,0.369073275862069,0.46516393442623,0.750262329485834,7.92271105826397,FALSE,2,13
"Buck Johnson",505,296,11849,1922,3942,7,62,1915,3880,766,1038,623,1137,1760,856,404,252,664,1403,4617,23.4633663366337,0.487569761542364,0.112903225806452,0.493556701030928,0.737957610789981,9.14257425742574,FALSE,2,7
"Buck Williams",1307,1140,42464,6404,11661,5,30,6399,11631,3971,5979,4526,8491,13017,1646,1080,1100,2784,4267,16784,32.4896710022953,0.549181030786382,0.166666666666667,0.550167655403663,0.664157885934103,12.8416220351951,FALSE,2,17
"Butch Carter",370,NA,6881,1297,2741,54,177,1243,2564,509,645,236,314,550,687,322,43,486,806,3157,18.5972972972973,0.47318496898942,0.305084745762712,0.484789391575663,0.789147286821705,8.53243243243243,FALSE,2,6
"Byron Houston",214,10,2674,307,673,10,39,297,634,211,312,237,411,648,114,103,86,173,543,835,12.4953271028037,0.456166419019316,0.256410256410256,0.468454258675079,0.676282051282051,3.9018691588785,FALSE,2,4
"Cal Bowdler",142,0,1383,163,403,2,11,161,392,96,125,90,182,272,29,42,45,43,155,424,9.73943661971831,0.404466501240695,0.181818181818182,0.410714285714286,0.768,2.98591549295775,FALSE,2,3
"Calbert Cheaney",825,498,22007,3366,7227,204,684,3162,6543,890,1288,732,1878,2610,1398,659,198,994,2074,7826,26.6751515151515,0.465753424657534,0.298245614035088,0.483264557542412,0.690993788819876,9.48606060606061,FALSE,2,13
"Calvin Garrett",166,NA,3008,375,820,6,20,369,800,99,129,139,297,436,242,94,18,165,327,855,18.1204819277108,0.457317073170732,0.3,0.46125,0.767441860465116,5.15060240963855,FALSE,2,4
"Carey Scurry",213,5,2831,375,784,11,40,364,744,226,338,254,354,608,242,231,166,238,457,987,13.2910798122066,0.478316326530612,0.275,0.489247311827957,0.668639053254438,4.63380281690141,FALSE,2,3
"Carl Herrera",493,110,8349,1069,2259,2,15,1067,2244,406,635,602,1150,1752,265,249,211,463,976,2546,16.9350912778905,0.473218238158477,0.133333333333333,0.475490196078431,0.639370078740157,5.16430020283976,FALSE,2,8
"Carl Landry",669,148,16001,2930,5516,10,37,2920,5479,1917,2447,1347,2001,3348,484,311,298,848,1638,7787,23.9177877428999,0.53118201595359,0.27027027027027,0.53294396787735,0.78340825500613,11.6397608370703,FALSE,2,9
"Carlos Delfino",507,170,11580,1472,3669,678,1856,794,1813,493,650,287,1528,1815,887,461,88,509,827,4115,22.8402366863905,0.401199236849278,0.365301724137931,0.437948152233867,0.758461538461538,8.1163708086785,FALSE,2,8
"Caron Butler",1011,819,32535,5259,12183,886,2538,4373,9645,2819,3332,1228,3849,5077,2245,1326,257,1814,2442,14223,32.1810089020772,0.431667077074612,0.34909377462569,0.453395541731467,0.846038415366146,14.0682492581602,FALSE,2,14
"Cartier Martin",320,23,4611,591,1498,294,786,297,712,223,302,126,515,641,170,135,35,181,436,1699,14.409375,0.394526034712951,0.374045801526718,0.417134831460674,0.73841059602649,5.309375,FALSE,2,7
"Casey Jacobsen",371,15,7118,641,1618,275,771,366,847,478,617,153,530,683,417,154,32,281,476,2035,19.1859838274933,0.396168108776267,0.356679636835279,0.43211334120425,0.774716369529984,5.48517520215633,FALSE,2,4
"Cedric Ceballos",746,378,17687,4001,8085,304,1005,3697,7080,1913,2539,1463,2452,3915,867,532,229,1180,1336,10219,23.7091152815013,0.494867037724181,0.302487562189055,0.522175141242938,0.753446238676644,13.6983914209115,FALSE,2,11
"Cedric Henderson",276,136,6214,791,1813,6,43,785,1770,319,444,176,595,771,419,228,111,409,582,1907,22.5144927536232,0.436293436293436,0.13953488372093,0.443502824858757,0.718468468468468,6.90942028985507,FALSE,2,5
"Cedric Simmons",107,4,876,85,210,0,0,85,210,30,85,66,109,175,16,14,41,38,107,200,8.18691588785047,0.404761904761905,NA,0.404761904761905,0.352941176470588,1.86915887850467,FALSE,2,3
"Cedrick Hordges",145,NA,2971,425,894,3,16,422,878,246,385,239,614,853,169,59,38,231,456,1099,20.4896551724138,0.475391498881432,0.1875,0.480637813211845,0.638961038961039,7.57931034482759,FALSE,2,2
"Charles Barkley",1073,1012,39330,8435,15605,538,2020,7897,13585,6349,8643,4260,8286,12546,4215,1648,888,3376,3287,23757,36.6542404473439,0.540531880807434,0.266336633663366,0.581302907618697,0.734582899456207,22.1407269338304,TRUE,2,16
"Charles Davis",497,34,6050,1171,2623,21,139,1150,2484,313,418,453,749,1202,380,151,83,406,776,2676,12.1730382293763,0.446435379336637,0.151079136690647,0.462962962962963,0.748803827751196,5.38430583501006,FALSE,2,8
"Charles Pittman",234,28,3292,379,694,0,5,379,689,302,425,278,440,718,204,75,73,310,454,1060,14.0683760683761,0.546109510086455,0,0.550072568940494,0.710588235294118,4.52991452991453,FALSE,2,4
"Charles Smith",908,493,21157,3678,7951,122,453,3556,7498,2352,3087,1412,2515,3927,1132,653,954,1328,2514,9830,23.3006607929515,0.462583322852471,0.269315673289183,0.47425980261403,0.761904761904762,10.8259911894273,FALSE,2,9
"Charlie Villanueva",656,163,13578,2652,6097,716,2101,1936,3996,788,1021,795,2224,3019,549,329,349,650,1453,6808,20.6981707317073,0.434968017057569,0.340790099952404,0.484484484484485,0.77179236043095,10.3780487804878,FALSE,2,11
"Chase Budinger",473,52,8927,1292,3005,437,1258,855,1747,448,569,281,1109,1390,537,245,75,354,547,3469,18.8731501057082,0.429950083194676,0.347376788553259,0.489410417859187,0.787346221441125,7.33403805496829,FALSE,2,7
"Chris Carr",393,72,6116,1002,2454,219,646,783,1808,503,622,240,662,902,401,131,63,455,660,2726,15.5623409669211,0.408312958435208,0.339009287925697,0.433075221238938,0.808681672025723,6.93638676844784,FALSE,2,6
"Chris Copeland",171,26,2111,366,858,154,422,212,436,112,149,65,207,272,107,32,30,129,237,998,12.3450292397661,0.426573426573427,0.364928909952607,0.486238532110092,0.751677852348993,5.83625730994152,FALSE,2,4
"Chris Crawford",252,92,3985,609,1393,70,202,539,1191,366,444,206,341,547,154,101,80,232,492,1654,15.8134920634921,0.437185929648241,0.346534653465347,0.452560873215785,0.824324324324324,6.56349206349206,FALSE,2,7
"Chris Douglas-Roberts",222,61,4381,574,1309,84,255,490,1054,339,408,83,389,472,254,128,55,200,287,1571,19.7342342342342,0.438502673796791,0.329411764705882,0.464895635673624,0.830882352941177,7.07657657657658,FALSE,2,6
"Chris King",103,66,2058,271,640,46,120,225,520,105,166,108,203,311,116,74,34,119,183,693,19.9805825242718,0.4234375,0.383333333333333,0.432692307692308,0.632530120481928,6.72815533980583,FALSE,2,3
"Chris McNealy",108,22,1864,181,397,0,0,181,397,104,158,160,334,494,110,90,30,116,274,466,17.2592592592593,0.455919395465995,NA,0.455919395465995,0.658227848101266,4.31481481481481,FALSE,2,3
"Chris Mills",568,328,17282,2391,5541,439,1251,1952,4290,1136,1391,772,2036,2808,1063,421,247,726,1532,6357,30.4260563380282,0.431510557661072,0.350919264588329,0.455011655011655,0.816678648454349,11.1919014084507,FALSE,2,10
"Chris Morris",747,436,18748,3144,7136,497,1625,2647,5511,1399,1894,1516,2028,3544,1182,917,540,1171,1750,8184,25.0977242302544,0.440582959641256,0.305846153846154,0.480312103066594,0.738648363252376,10.9558232931727,FALSE,2,11
"Chris Mullin",986,822,32163,6740,13243,815,2120,5925,11123,3616,4178,1026,3008,4034,3450,1530,549,2315,2050,17911,32.6196754563895,0.508948123536963,0.384433962264151,0.532680032365369,0.865485878410723,18.1653144016227,TRUE,2,16
"Chris Singleton",148,62,2605,233,620,58,182,175,438,88,139,112,360,472,92,117,57,100,325,612,17.6013513513514,0.375806451612903,0.318681318681319,0.399543378995434,0.633093525179856,4.13513513513514,FALSE,2,3
"Chuck Person",943,622,28941,5576,12176,1220,3370,4356,8806,1486,2056,1162,3601,4763,2645,683,197,1952,2565,13858,30.6903499469777,0.457950065703022,0.362017804154303,0.494662729956848,0.722762645914397,14.695652173913,FALSE,2,13
"Chucky Brown",895,299,14585,2038,4192,25,119,2013,4073,814,1177,780,1819,2599,680,278,270,638,1476,4915,16.2960893854749,0.486164122137405,0.210084033613445,0.494230297078321,0.691588785046729,5.49162011173184,FALSE,2,13
"Clarence Weatherspoon",1046,662,30929,4397,9356,10,52,4387,9304,2676,3610,2398,5246,7644,1465,995,883,1584,2297,11480,29.5688336520076,0.469965797349295,0.192307692307692,0.471517626827171,0.741274238227147,10.9751434034417,FALSE,2,13
"Clark Kellogg",260,241,8514,2008,4041,23,68,1985,3973,879,1161,852,1630,2482,764,381,105,731,858,4918,32.7461538461538,0.496906706260827,0.338235294117647,0.499622451547949,0.757105943152455,18.9153846153846,FALSE,2,5
"Cliff Levingston",830,216,16962,2333,4524,5,33,2328,4491,1217,1800,1772,2535,4307,752,534,593,829,2299,5888,20.4361445783133,0.515694076038904,0.151515151515152,0.518370073480294,0.676111111111111,7.09397590361446,FALSE,2,11
"Corey Maggette",827,478,23358,4065,8969,463,1431,3602,7538,4605,5599,915,3107,4022,1696,590,139,1874,2338,13198,28.2442563482467,0.45322778459137,0.323549965059399,0.477845582382595,0.822468297910341,15.9588875453446,FALSE,2,14
"Corliss Williamson",963,342,21962,4201,8586,6,48,4195,8538,2281,3191,1428,2335,3763,1111,550,297,1512,2653,10689,22.8058151609553,0.489284882366643,0.125,0.491332864839541,0.714822939517393,11.0996884735202,FALSE,2,12
"Craig Smith",403,49,6826,1221,2207,1,27,1220,2180,637,963,543,1024,1567,322,183,91,413,957,3080,16.9379652605459,0.553239691889443,0.037037037037037,0.559633027522936,0.66147455867082,7.64267990074442,FALSE,2,6
"Daequan Cook",377,50,6434,809,2223,468,1323,341,900,165,204,82,682,764,262,128,55,192,504,2251,17.0663129973475,0.363922627080522,0.353741496598639,0.378888888888889,0.808823529411765,5.97082228116711,FALSE,2,6
"Dahntay Jones",702,176,10815,1285,2961,118,374,1167,2587,927,1231,276,907,1183,577,283,150,545,1325,3615,15.4059829059829,0.433975008443094,0.315508021390374,0.451101662156939,0.753046303818034,5.14957264957265,FALSE,2,13
"Dale Ellis",1302,618,36766,7729,16152,1813,4523,5916,11629,2768,3544,1612,2818,4430,1855,1036,191,1872,2637,20039,28.2380952380952,0.478516592372462,0.400840150342693,0.508728179551122,0.781038374717833,15.3909370199693,FALSE,2,17
"Dallas Comegys",142,27,2241,322,704,0,3,322,701,212,311,166,286,452,95,78,133,201,335,856,15.7816901408451,0.457386363636364,0,0.459343794579173,0.681672025723473,6.02816901408451,FALSE,2,2
"Damjan Rude≈æ",146,2,1638,175,413,106,284,69,129,24,31,18,74,92,84,31,7,69,143,480,11.2191780821918,0.423728813559322,0.373239436619718,0.534883720930233,0.774193548387097,3.28767123287671,FALSE,2,3
"Dan Langhi",139,8,1290,177,454,12,40,165,414,40,64,54,149,203,39,30,12,37,113,406,9.28057553956834,0.389867841409692,0.3,0.398550724637681,0.625,2.92086330935252,FALSE,2,4
"Dan Majerle",955,454,30206,3950,9171,1360,3798,2590,5373,1665,2246,1125,3140,4265,2755,1194,360,1116,1927,10925,31.6293193717277,0.430705484679969,0.358083201685097,0.482039828773497,0.741317898486198,11.4397905759162,FALSE,2,14
"Danny Ferry",917,186,18133,2505,5615,677,1724,1828,3891,752,895,647,1903,2550,1185,384,292,811,1964,6439,19.7742639040349,0.446126447016919,0.392691415313225,0.469802107427397,0.840223463687151,7.02181025081788,FALSE,2,13
"Danny Granger",627,433,19334,3448,7979,1049,2772,2399,5207,2248,2644,705,2316,3021,1138,573,498,1144,1690,10193,30.8357256778309,0.432134352675774,0.378427128427128,0.460725945842136,0.850226928895613,16.2567783094099,FALSE,2,10
"Danny Manning",951,464,26722,5612,11036,44,216,5568,10820,2502,3461,1654,3426,5080,2324,1099,834,2086,3155,13770,28.0988433228181,0.50851757883291,0.203703703703704,0.51460258780037,0.722912453048252,14.4794952681388,FALSE,2,15
"Danny Vranes",510,246,10624,1056,2131,2,19,1054,2112,499,875,763,1235,1998,594,333,270,519,1368,2613,20.8313725490196,0.495541999061474,0.105263157894737,0.49905303030303,0.570285714285714,5.12352941176471,FALSE,2,7
"Darius Miles",525,246,13809,2239,4726,29,171,2210,4555,861,1443,687,1862,2549,1002,451,556,1022,1191,5368,26.3028571428571,0.473762166737198,0.169590643274854,0.485181119648738,0.596673596673597,10.2247619047619,FALSE,2,7
"Darnell Jackson",166,4,1162,132,304,5,21,127,283,62,96,99,126,225,30,26,15,63,180,331,7,0.43421052631579,0.238095238095238,0.448763250883392,0.645833333333333,1.99397590361446,FALSE,2,3
"Darren Daye",390,24,5939,950,1932,2,17,948,1915,559,836,358,611,969,748,216,60,486,707,2461,15.2282051282051,0.491718426501035,0.117647058823529,0.495039164490862,0.66866028708134,6.31025641025641,FALSE,2,5
"Darrin Hancock",157,14,1528,212,405,2,6,210,399,83,140,62,125,187,101,65,11,108,172,509,9.73248407643312,0.523456790123457,0.333333333333333,0.526315789473684,0.592857142857143,3.24203821656051,FALSE,2,3
"Darvin Ham",453,48,5496,476,918,4,16,472,902,266,539,501,518,1019,243,145,162,330,823,1222,12.1324503311258,0.518518518518518,0.25,0.523281596452328,0.493506493506494,2.69757174392936,FALSE,2,8
"David Benoit",569,179,10437,1487,3459,266,831,1221,2628,635,796,636,1550,2186,312,251,266,476,1178,3875,18.3427065026362,0.429893032668401,0.320096269554753,0.464611872146119,0.797738693467337,6.81019332161687,FALSE,2,7
"David Thirdkill",197,8,1652,209,452,1,12,208,440,142,251,89,137,226,88,52,16,119,248,561,8.38578680203046,0.462389380530973,0.0833333333333333,0.472727272727273,0.565737051792829,2.84771573604061,FALSE,2,5
"David Wingate",740,218,13243,1690,3798,79,290,1611,3508,707,958,445,975,1420,1376,597,122,853,1249,4166,17.8959459459459,0.444971037388099,0.272413793103448,0.459236031927024,0.737995824634656,5.62972972972973,FALSE,2,15
"David Wood",474,31,6323,642,1437,131,390,511,1047,395,505,439,719,1158,325,183,86,260,1083,1810,13.3396624472574,0.446764091858038,0.335897435897436,0.488061127029608,0.782178217821782,3.81856540084388,FALSE,2,7
"Dennis Hopson",405,119,8823,1651,3786,73,272,1578,3514,1001,1327,526,619,1145,641,386,198,648,787,4376,21.7851851851852,0.43608029582673,0.268382352941176,0.449060899260102,0.754333082140166,10.8049382716049,FALSE,2,5
"Dennis Rodman",911,573,28839,2766,5310,82,355,2684,4955,1069,1832,4329,7625,11954,1600,611,531,1484,2843,6683,31.6564215148189,0.52090395480226,0.230985915492958,0.54167507568113,0.583515283842795,7.33589462129528,TRUE,2,14
"Dennis Scott",746,430,21011,3378,8152,1376,3499,2002,4653,1084,1367,422,1657,2079,1489,593,239,891,1476,9216,28.1648793565684,0.414376840039254,0.393255215775936,0.430260047281324,0.792977322604243,12.3538873994638,FALSE,2,10
"Derek Anderson",658,401,19022,2527,6225,685,2025,1842,4200,1967,2309,461,1670,2131,2184,714,93,1106,1328,7706,28.9088145896657,0.405943775100402,0.338271604938272,0.438571428571429,0.851883932438285,11.7112462006079,FALSE,2,11
"Derek Smith",473,252,11120,2247,4570,52,184,2195,4386,1254,1683,537,930,1467,994,308,198,788,1378,5800,23.5095137420719,0.491684901531729,0.282608695652174,0.500455996352029,0.745098039215686,12.262156448203,FALSE,2,9
"Derek Strong",456,72,8548,1067,2483,11,61,1056,2422,943,1199,783,1430,2213,291,203,94,421,740,3088,18.7456140350877,0.429722110350383,0.180327868852459,0.436003303055326,0.786488740617181,6.7719298245614,FALSE,2,10
"DerMarr Johnson",344,136,5930,770,1872,274,815,496,1057,307,389,192,577,769,304,198,149,349,598,2121,17.2383720930233,0.411324786324786,0.336196319018405,0.469252601702933,0.789203084832905,6.1656976744186,FALSE,2,7
"Derrick Brown",220,19,3130,428,818,18,51,410,767,206,333,208,304,512,152,109,42,144,267,1080,14.2272727272727,0.523227383863081,0.352941176470588,0.534550195567145,0.618618618618619,4.90909090909091,FALSE,2,3
"Derrick Chievous",209,1,2831,504,1120,11,42,493,1078,360,482,195,259,454,141,103,22,232,317,1379,13.5454545454545,0.45,0.261904761904762,0.457328385899814,0.746887966804979,6.59808612440191,FALSE,2,3
"Derrick McKey",937,639,27229,3908,8048,203,642,3705,7406,2247,2885,1515,2872,4387,2254,1072,611,1713,2700,10266,29.059765208111,0.48558648111332,0.31619937694704,0.500270051309749,0.778856152512998,10.9562433297759,FALSE,2,15
"DeShawn Stevenson",968,638,21723,2660,6549,588,1775,2072,4774,1067,1535,500,1721,2221,1569,491,157,964,1354,6975,22.4411157024793,0.406168880745152,0.331267605633803,0.434017595307918,0.695114006514658,7.20557851239669,FALSE,2,13
"Desmond Mason",723,425,22404,3388,7552,87,326,3301,7226,2051,2768,958,2428,3386,1212,508,262,1147,1642,8914,30.9875518672199,0.448622881355932,0.266871165644172,0.456822585109327,0.740968208092486,12.32918395574,FALSE,2,10
"Detlef Schrempf",1205,537,35447,5674,11573,482,1271,5192,10302,4759,5935,1997,5421,7418,4012,909,331,2401,3580,16589,29.4165975103734,0.490279097900285,0.379228953579858,0.50397980974568,0.801853411962932,13.7668049792531,FALSE,2,16
"Devean George",630,108,11682,1318,3360,427,1246,891,2114,473,656,546,1429,1975,543,436,230,447,1270,3536,18.5428571428571,0.392261904761905,0.342696629213483,0.421475875118259,0.721036585365854,5.61269841269841,FALSE,2,11
"Dominic McGuire",419,96,6042,431,1035,3,16,428,1019,163,260,386,940,1326,453,172,199,271,575,1028,14.4200477326969,0.416425120772947,0.1875,0.420019627085378,0.626923076923077,2.45346062052506,FALSE,2,6
"Dominique Wilkins",1148,1069,40748,10661,23177,796,2526,9865,20651,6473,7960,3132,4518,7650,2846,1470,672,2841,2187,28591,35.4947735191638,0.45998187858653,0.315122723673793,0.477700837731829,0.813190954773869,24.9050522648084,TRUE,2,15
"Don Collins",384,NA,7979,1595,3359,2,35,1593,3324,722,954,558,547,1105,736,436,123,722,1014,3914,20.7786458333333,0.47484370348318,0.0571428571428571,0.479241877256318,0.756813417190776,10.1927083333333,FALSE,2,6
"Don MacLean",319,111,6679,1320,2902,56,197,1264,2705,794,1038,356,854,1210,404,118,51,398,598,3490,20.9373040752351,0.454858718125431,0.284263959390863,0.46728280961183,0.764932562620424,10.9404388714734,FALSE,2,9
"Don Reid",441,152,5872,643,1211,0,1,643,1210,312,472,468,803,1271,154,206,313,276,1253,1598,13.3151927437642,0.530966143682907,0,0.531404958677686,0.661016949152542,3.62358276643991,FALSE,2,8
"Donald Royal",597,97,9623,1051,2251,0,16,1051,2235,1356,1752,624,1002,1626,542,277,111,600,1003,3458,16.1189279731993,0.466903598400711,0,0.470246085011186,0.773972602739726,5.79229480737018,FALSE,2,8
"Donnell Harvey",312,51,4942,650,1403,1,13,649,1390,358,542,389,829,1218,219,142,131,287,708,1659,15.8397435897436,0.463292943692088,0.0769230769230769,0.466906474820144,0.660516605166052,5.31730769230769,FALSE,2,5
"Donny Marshall",119,0,919,87,271,42,125,45,146,77,113,39,82,121,36,37,5,45,107,293,7.72268907563025,0.321033210332103,0.336,0.308219178082192,0.68141592920354,2.46218487394958,FALSE,2,5
"Dont√© Greene",253,82,4259,585,1441,165,542,420,899,206,294,140,460,600,183,111,116,222,373,1541,16.8339920948617,0.405968077723803,0.304428044280443,0.467185761957731,0.700680272108844,6.09090909090909,FALSE,2,4
"Dontonio Wingfield",114,2,1146,157,404,47,152,110,252,62,86,121,154,275,76,39,15,89,191,423,10.0526315789474,0.388613861386139,0.30921052631579,0.436507936507937,0.72093023255814,3.71052631578947,FALSE,2,4
"Donyell Marshall",1137,528,30441,4943,11404,1117,3199,3826,8205,1922,2645,2269,5396,7665,1542,934,1076,1539,2608,12925,26.7730870712401,0.433444405471764,0.349171616130041,0.466301035953687,0.726654064272212,11.3676341248901,FALSE,2,15
"Dorell Wright",549,222,12280,1657,3908,617,1691,1040,2217,666,826,375,1718,2093,850,418,271,475,790,4597,22.367941712204,0.424002047082907,0.364872856298048,0.469102390617952,0.806295399515738,8.37340619307832,FALSE,2,11
"Doug Christie",934,769,28640,3518,8273,866,2440,2652,5833,2159,2631,869,2844,3713,3308,1705,429,1920,2298,10061,30.6638115631692,0.425238728393569,0.354918032786885,0.454654551688668,0.820600532117066,10.771948608137,FALSE,2,15
"Doug Smith",296,118,5833,1020,2399,3,36,1017,2363,313,405,394,840,1234,400,224,150,353,979,2356,19.7060810810811,0.425177157148812,0.0833333333333333,0.43038510368176,0.77283950617284,7.95945945945946,FALSE,2,5
"Duane Ferrell",583,72,8734,1420,2961,42,146,1378,2815,822,1096,552,580,1132,509,302,105,509,902,3704,14.9811320754717,0.479567713610267,0.287671232876712,0.489520426287744,0.75,6.35334476843911,FALSE,2,11
"Earl Clark",357,71,4862,618,1544,123,377,495,1167,199,307,254,768,1022,161,108,179,234,435,1558,13.6190476190476,0.400259067357513,0.326259946949602,0.424164524421594,0.648208469055375,4.3641456582633,FALSE,2,6
"Ed Nealy",624,82,7358,592,1216,46,159,546,1057,320,470,619,1322,1941,421,275,54,240,979,1550,11.7916666666667,0.486842105263158,0.289308176100629,0.516556291390728,0.680851063829787,2.48397435897436,FALSE,2,10
"Ed O'Bannon",192,39,2871,342,958,46,196,296,762,139,178,165,299,464,141,102,35,102,289,869,14.953125,0.356993736951983,0.23469387755102,0.388451443569554,0.780898876404494,4.52604166666667,FALSE,2,2
"Ed Pinckney",947,415,19420,2405,4534,0,27,2405,4507,1964,2553,1842,3017,4859,917,759,529,1041,1889,6774,20.506863780359,0.530436700485223,0,0.53361437763479,0.769291030160595,7.15311510031679,FALSE,2,12
"Eddie Jones",1068,993,36253,5370,12303,1672,4511,3698,7792,3016,3740,842,3399,4241,3107,1813,648,1647,2735,15428,33.9447565543071,0.436478907583516,0.370649523387276,0.47458932238193,0.806417112299465,14.4456928838951,FALSE,2,14
"Eddie Robinson",278,48,5345,852,1681,8,32,844,1649,226,306,241,523,764,252,216,91,215,345,1938,19.226618705036,0.506841165972635,0.25,0.511825348696179,0.738562091503268,6.97122302158273,FALSE,2,5
"Edgar Jones",484,NA,9387,1574,3138,18,74,1556,3064,1110,1561,748,1616,2364,449,282,592,770,1554,4276,19.3946280991736,0.501593371574251,0.243243243243243,0.507832898172324,0.71108263933376,8.83471074380165,FALSE,2,6
"Eduardo N√°jera",733,94,13083,1411,2973,135,439,1276,2534,606,911,1033,1632,2665,587,513,269,488,1620,3563,17.8485675306958,0.474604776320215,0.30751708428246,0.503551696921863,0.665203073545554,4.86084583901774,FALSE,2,12
"Elston Turner",505,97,9006,1049,2429,7,46,1042,2383,292,409,556,819,1375,914,442,27,455,910,2397,17.8336633663366,0.431864965006175,0.152173913043478,0.43726395300042,0.713936430317848,4.74653465346535,FALSE,2,8
"Eric Piatkowski",789,250,14613,2044,4711,865,2168,1179,2543,966,1152,508,1208,1716,778,404,115,628,1152,5919,18.5209125475285,0.433878157503715,0.398985239852399,0.463625639009044,0.838541666666667,7.50190114068441,FALSE,2,14
"Eric Williams",805,383,19060,2257,5465,290,907,1967,4558,2028,2759,816,1798,2614,1155,659,116,944,1935,6832,23.6770186335404,0.412991765782251,0.31973539140022,0.431548924967091,0.735048930772019,8.48695652173913,FALSE,2,12
"Francisco Garc√≠a",607,157,12882,1682,3959,648,1806,1034,2153,632,789,286,1205,1491,810,487,426,577,1317,4644,21.2224052718287,0.424854761303359,0.358803986710963,0.480260102183,0.801013941698352,7.6507413509061,FALSE,2,10
"Fred Jones",493,90,11618,1229,3012,385,1107,844,1905,775,955,180,893,1073,1098,384,131,578,952,3618,23.5659229208925,0.408034528552457,0.347786811201445,0.443044619422572,0.81151832460733,7.33874239350913,FALSE,2,7
"Gary Forbes",111,13,1504,236,544,48,141,188,403,125,178,55,163,218,103,47,10,100,133,645,13.5495495495495,0.433823529411765,0.340425531914894,0.466501240694789,0.702247191011236,5.81081081081081,FALSE,2,2
"Gary Plummer",126,0,1439,198,460,1,7,197,453,134,187,107,200,307,66,29,25,128,268,531,11.4206349206349,0.430434782608696,0.142857142857143,0.434878587196468,0.716577540106952,4.21428571428571,FALSE,2,2
"Gene Banks",468,264,13074,2134,3961,2,46,2132,3915,1035,1418,1009,1709,2718,1335,436,101,835,1289,5305,27.9358974358974,0.538752840191871,0.0434782608695652,0.544572158365262,0.729901269393512,11.3354700854701,FALSE,2,6
"George Lynch",774,420,17683,2086,4677,146,477,1940,4200,791,1213,1508,2394,3902,1121,817,258,890,1675,5109,22.8462532299742,0.446012401111824,0.306079664570231,0.461904761904762,0.652102225886232,6.60077519379845,FALSE,2,12
"George McCloud",830,222,18922,2707,6718,1019,2827,1688,3891,1150,1419,695,1826,2521,1878,654,198,1131,1772,7583,22.7975903614458,0.402947305745758,0.360452776795189,0.433821639681316,0.810429880197322,9.13614457831325,FALSE,2,12
"Gerald Glass",276,54,4266,840,1955,34,149,806,1806,181,281,295,367,662,379,166,77,214,475,1895,15.4565217391304,0.429667519181586,0.228187919463087,0.446290143964563,0.644128113879004,6.86594202898551,FALSE,2,4
"Gerald Paddio",147,27,1762,327,785,8,34,319,751,106,146,65,135,200,145,42,12,99,113,768,11.9863945578231,0.41656050955414,0.235294117647059,0.424766977363515,0.726027397260274,5.22448979591837,FALSE,2,3
"Gerald Wallace",961,732,29500,4189,8975,515,1639,3674,7336,2953,4116,1343,4450,5793,2062,1390,780,1749,2157,11846,30.6971904266389,0.466740947075209,0.314215985356925,0.500817884405671,0.717444120505345,12.3267429760666,FALSE,2,14
"Gerald Wilkins",900,653,26084,4754,10564,418,1322,4336,9242,1810,2429,975,1671,2646,2697,907,208,1687,1853,11736,28.9822222222222,0.450018932222643,0.316187594553706,0.469162518935295,0.745162618361466,13.04,FALSE,2,13
"Gerard King",126,31,1829,235,467,0,0,235,467,96,129,129,264,393,84,50,27,92,238,566,14.515873015873,0.50321199143469,NA,0.50321199143469,0.744186046511628,4.49206349206349,FALSE,2,3
"Glen Rice",1000,876,34985,6776,14867,1559,3896,5217,10971,3225,3813,946,3441,4387,2097,958,265,1733,2361,18336,34.985,0.455774534203269,0.400154004106776,0.475526387749521,0.845790715971676,18.336,FALSE,2,15
"Glenn Robinson",688,668,25346,5571,12129,620,1823,4951,10306,2472,3016,1027,3162,4189,1879,826,389,2147,1847,14234,36.8401162790698,0.459312391788276,0.34009873834339,0.480399767125946,0.819628647214854,20.6889534883721,FALSE,2,11
"Gordan Giriƒçek",589,296,13844,2223,5054,470,1286,1753,3768,841,1015,270,1231,1501,905,354,74,817,1134,5757,23.5042444821732,0.43984962406015,0.36547433903577,0.465233545647558,0.828571428571429,9.7741935483871,FALSE,2,6
"Grant Hill",1026,972,34776,6345,13126,219,697,6126,12429,4228,5498,1176,4993,6169,4252,1248,576,2459,2377,17137,33.8947368421053,0.483391741581594,0.314203730272597,0.492879555877384,0.76900691160422,16.7027290448343,TRUE,2,18
"Grant Long",1084,752,31155,3814,8156,94,324,3720,7832,2735,3597,2359,4401,6760,1847,1308,400,1783,3200,10457,28.7407749077491,0.467631191760667,0.290123456790123,0.474974463738509,0.760355852098971,9.64667896678967,FALSE,2,15
"Greg Buckner",570,117,10895,1120,2491,239,716,881,1775,399,527,457,1136,1593,719,454,111,394,1342,2878,19.1140350877193,0.449618627057407,0.333798882681564,0.496338028169014,0.757115749525617,5.04912280701754,FALSE,2,10
"Greg Minor",277,93,5144,794,1662,24,106,770,1556,290,378,258,483,741,384,156,46,225,464,1902,18.5703971119134,0.477737665463297,0.226415094339623,0.494858611825193,0.767195767195767,6.86642599277978,FALSE,2,5
"Hakim Warrick",630,128,12670,2108,4342,22,120,2086,4222,1636,2254,840,1680,2520,477,255,178,733,1132,5874,20.1111111111111,0.485490557346845,0.183333333333333,0.494078635717669,0.725820763087844,9.32380952380952,FALSE,2,8
"Hank McDowell",262,1,2362,287,634,0,9,287,625,189,261,240,343,583,122,42,40,171,358,763,9.01526717557252,0.452681388012618,0,0.4592,0.724137931034483,2.91221374045802,FALSE,2,6
"Harold Ellis",145,26,1923,312,592,1,21,311,571,215,329,177,114,291,89,159,18,111,252,840,13.2620689655172,0.527027027027027,0.0476190476190476,0.544658493870403,0.653495440729483,5.79310344827586,FALSE,2,3
"Harold Pressley",299,118,6802,1075,2458,208,581,867,1877,344,442,517,822,1339,628,275,188,410,670,2702,22.7491638795987,0.437347436940602,0.358003442340792,0.461907298881193,0.778280542986425,9.03678929765886,FALSE,2,4
"Harvey Grant",783,439,20510,3345,7138,65,243,3280,6895,1026,1448,1170,2266,3436,1219,599,428,714,1768,7781,26.1941251596424,0.468618660689269,0.267489711934156,0.475707034082669,0.708563535911602,9.93742017879949,FALSE,2,11
"Hedo T√ºrkoƒülu",1078,643,29235,4173,9756,1373,3556,2800,6200,2180,2801,692,3635,4327,3175,822,333,1710,2650,11899,27.1196660482375,0.427736777367774,0.386107986501687,0.451612903225806,0.778293466619065,11.0380333951763,FALSE,2,15
"Henry James",222,24,2791,493,1190,155,415,338,775,218,268,113,216,329,88,51,18,141,315,1359,12.5720720720721,0.414285714285714,0.373493975903614,0.436129032258065,0.813432835820896,6.12162162162162,FALSE,2,7
"Henry Walker",216,48,3784,506,1097,240,631,266,466,156,203,70,419,489,193,116,30,170,458,1408,17.5185185185185,0.461257976298997,0.380348652931854,0.570815450643777,0.768472906403941,6.51851851851852,FALSE,2,5
"Hollis Thompson",305,99,7176,819,1995,395,1036,424,959,222,316,218,723,941,327,186,74,224,610,2255,23.527868852459,0.410526315789474,0.381274131274131,0.442127215849844,0.70253164556962,7.39344262295082,FALSE,2,4
"Ike Diogu",313,21,3770,654,1298,2,4,652,1294,523,665,376,572,948,97,47,94,279,570,1833,12.0447284345048,0.503852080123267,0.5,0.50386398763524,0.786466165413534,5.85623003194888,FALSE,2,6
"Ime Udoka",316,80,5711,614,1471,218,612,396,859,189,268,219,707,926,308,208,54,221,528,1635,18.0727848101266,0.417403127124405,0.356209150326797,0.461001164144354,0.705223880597015,5.17405063291139,FALSE,2,7
"Ira Newble",429,210,8343,858,1927,101,298,757,1629,301,387,450,789,1239,360,232,113,323,764,2118,19.4475524475524,0.445251686559419,0.338926174496644,0.464702271332106,0.777777777777778,4.93706293706294,FALSE,2,8
"Ivan Johnson",125,5,1969,326,631,3,19,323,612,153,231,141,351,492,78,99,32,140,247,808,15.752,0.516640253565769,0.157894736842105,0.527777777777778,0.662337662337662,6.464,FALSE,2,2
"Ivano Newbill",134,4,1430,76,193,1,1,75,192,45,104,140,214,354,50,50,29,71,213,198,10.6716417910448,0.393782383419689,1,0.390625,0.432692307692308,1.47761194029851,FALSE,2,3
"J.J. Anderson",222,4,3172,496,1037,0,13,496,1024,239,424,305,428,733,177,170,60,210,404,1231,14.2882882882883,0.478302796528447,0,0.484375,0.563679245283019,5.54504504504505,FALSE,2,3
"Jalen Rose",1144,764,35558,6188,14040,963,2722,5225,11318,3486,4341,596,3447,4043,4392,888,395,2626,2999,16825,31.0821678321678,0.440740740740741,0.353783982365907,0.461654002473935,0.803040774015204,14.7071678321678,FALSE,2,13
"Jamal Mashburn",680,635,24926,4563,10965,857,2503,3706,8462,2483,3260,766,2799,3565,2618,710,121,1699,1719,12466,36.6558823529412,0.416142270861833,0.342389133040352,0.437957929567478,0.761656441717791,18.3323529411765,FALSE,2,11
"Jamario Moon",425,237,9561,1046,2290,280,844,766,1446,267,326,282,1475,1757,438,343,329,212,622,2639,22.4964705882353,0.456768558951965,0.33175355450237,0.529737206085754,0.819018404907976,6.20941176470588,FALSE,2,5
"James Anderson",286,85,4721,577,1402,217,671,360,731,200,261,126,506,632,333,136,60,241,317,1571,16.506993006993,0.411554921540656,0.323397913561848,0.492476060191518,0.766283524904215,5.49300699300699,FALSE,2,5
"James Jones",709,93,11098,1205,3003,776,1937,429,1066,531,632,226,1050,1276,366,226,218,231,930,3717,15.6530324400564,0.401265401265401,0.400619514713474,0.402439024390244,0.840189873417722,5.2425952045134,FALSE,2,14
"James Posey",947,550,25778,2804,6843,1105,3196,1699,3647,1599,1947,845,3642,4487,1597,1023,313,1125,2527,8312,27.220696937698,0.40976180037995,0.345744680851064,0.465862352618591,0.821263482280431,8.77719112988384,FALSE,2,12
"James Ray",103,NA,843,136,318,1,3,135,315,61,97,68,160,228,76,38,39,100,173,334,8.18446601941748,0.427672955974843,0.333333333333333,0.428571428571429,0.628865979381443,3.24271844660194,FALSE,2,3
"James Singleton",300,22,4229,459,1037,42,157,417,880,248,296,429,757,1186,140,125,160,189,503,1208,14.0966666666667,0.442622950819672,0.267515923566879,0.473863636363636,0.837837837837838,4.02666666666667,FALSE,2,5
"James Wilkes",114,NA,1531,224,484,0,3,224,481,99,137,107,167,274,104,58,31,101,220,547,13.4298245614035,0.462809917355372,0,0.465696465696466,0.722627737226277,4.79824561403509,FALSE,2,3
"James Worthy",926,717,30001,6878,13204,117,486,6761,12718,2447,3184,1561,3147,4708,2791,1041,624,1859,1975,16320,32.3984881209503,0.520902756740382,0.240740740740741,0.531608743513131,0.768530150753769,17.6241900647948,TRUE,2,12
"Jamie Watson",125,13,1588,157,341,16,50,141,291,71,101,57,139,196,150,87,21,117,185,401,12.704,0.460410557184751,0.32,0.484536082474227,0.702970297029703,3.208,FALSE,2,4
"Jan Vesel√Ω",216,26,3231,352,678,0,2,352,676,83,213,306,447,753,117,160,119,159,505,787,14.9583333333333,0.519174041297935,0,0.520710059171598,0.389671361502347,3.64351851851852,FALSE,2,3
"Jared Jeffries",741,381,15974,1331,3128,96,372,1235,2756,691,1185,1358,1609,2967,935,528,411,771,1807,3449,21.557354925776,0.425511508951407,0.258064516129032,0.44811320754717,0.583122362869198,4.65452091767881,FALSE,2,11
"Jared Sullinger",269,172,6532,1172,2685,141,518,1031,2167,408,564,684,1322,2006,477,180,161,332,784,2893,24.2825278810409,0.436499068901304,0.272200772200772,0.47577295800646,0.723404255319149,10.7546468401487,FALSE,2,5
"Jarvis Hayes",427,115,9898,1397,3363,392,1101,1005,2262,367,460,244,1086,1330,459,312,56,374,852,3553,23.1803278688525,0.415402914064823,0.356039963669391,0.444297082228117,0.797826086956522,8.3208430913349,FALSE,2,7
"Jason Caffey",542,184,10468,1502,3118,0,10,1502,3108,947,1482,1001,1365,2366,487,234,130,752,1329,3951,19.3136531365314,0.481719050673509,0,0.483268983268983,0.639001349527665,7.28966789667897,FALSE,2,8
"Jason Kapono",509,87,9068,1336,3026,457,1054,879,1972,269,322,165,679,844,417,180,25,327,777,3398,17.8153241650295,0.441506939854594,0.433586337760911,0.445740365111562,0.835403726708075,6.67583497053045,FALSE,2,9
"Jason Richardson",1009,993,34366,6495,14711,1926,5148,4569,9563,2189,3072,1177,3718,4895,2577,1164,408,1693,2271,17105,34.0594648166501,0.441506355788186,0.374125874125874,0.477778939663286,0.712565104166667,16.9524281466799,FALSE,2,13
"Jay Vincent",646,235,16661,3680,7807,6,32,3674,7775,1826,2335,1037,2302,3339,1169,437,181,1174,1736,9192,25.7910216718266,0.471371845779429,0.1875,0.472540192926045,0.782012847965739,14.2291021671827,FALSE,2,9
"Jeff Adrien",206,29,3109,407,832,0,2,407,830,257,407,323,642,965,138,74,115,130,367,1071,15.0922330097087,0.489182692307692,0,0.490361445783133,0.631449631449631,5.19902912621359,FALSE,2,5
"Jeff Grayer",443,101,8311,1340,2936,37,143,1303,2793,550,829,574,724,1298,637,273,65,488,739,3267,18.7607223476298,0.456403269754768,0.258741258741259,0.466523451485857,0.663449939686369,7.37471783295711,FALSE,2,9
"Jeff Lamp",365,5,4792,852,1806,19,84,833,1722,380,453,184,453,637,386,144,18,287,555,2103,13.1287671232877,0.471760797342193,0.226190476190476,0.483739837398374,0.838852097130243,5.76164383561644,FALSE,2,6
"Jeff Taylor",188,55,3384,369,901,82,258,287,643,166,247,106,239,345,220,114,37,160,320,986,18,0.409544950055494,0.317829457364341,0.446345256609642,0.672064777327935,5.24468085106383,FALSE,2,3
"Jeff Turner",612,235,11244,1543,3304,73,212,1470,3092,538,700,621,1415,2036,635,215,85,687,1758,3697,18.3725490196078,0.467009685230024,0.344339622641509,0.475420439844761,0.768571428571429,6.04084967320261,FALSE,2,10
"Jerome Kersey",1153,571,28115,4723,10166,58,288,4665,9878,2321,3364,2330,4009,6339,2134,1439,799,1583,3455,11825,24.3842150910668,0.464587841825694,0.201388888888889,0.472261591415266,0.689952437574316,10.2558542931483,FALSE,2,17
"Jerome Lane",232,84,3392,511,1172,1,16,510,1156,168,447,599,725,1324,339,140,40,275,574,1191,14.6206896551724,0.436006825938567,0.0625,0.441176470588235,0.375838926174497,5.13362068965517,FALSE,2,5
"Jerome Williams",714,205,15574,1719,3469,1,37,1718,3432,1220,1863,1758,2842,4600,591,765,156,724,1487,4659,21.812324929972,0.495531853560104,0.027027027027027,0.500582750582751,0.654857756307032,6.52521008403361,FALSE,2,9
"Jerrod Mustaf",179,19,1902,285,635,0,2,285,633,151,233,145,307,452,99,54,46,144,237,721,10.6256983240223,0.448818897637795,0,0.450236966824645,0.648068669527897,4.02793296089385,FALSE,2,4
"Jerry Reynolds",443,118,8379,1420,3399,28,124,1392,3275,1168,1560,467,850,1317,904,486,250,718,677,4036,18.9142212189616,0.417769932333039,0.225806451612903,0.425038167938931,0.748717948717949,9.11060948081264,FALSE,2,8
"Jerry Stackhouse",1049,601,32767,5810,14157,1035,3397,4775,10760,5003,6109,1031,2302,3333,3481,958,496,2865,1985,17658,31.2364156339371,0.410397683124956,0.304680600529879,0.443773234200743,0.818955639220822,16.8331744518589,FALSE,2,18
"Jim Jackson",1201,873,39133,6265,14757,1194,3300,5071,11457,2870,3483,1549,3983,5532,3929,991,249,2930,2695,16594,32.5836802664446,0.424544284068578,0.361818181818182,0.442611503884088,0.824002296870514,13.8168193172356,FALSE,2,14
"Ji≈ô√≠ Welsch",318,134,5913,665,1651,152,454,513,1197,498,660,146,623,769,478,231,20,335,515,1980,18.5943396226415,0.402786190187765,0.334801762114537,0.428571428571429,0.754545454545455,6.22641509433962,FALSE,2,4
"Joe Courtney",169,2,1298,197,455,4,6,193,449,92,140,106,125,231,45,35,40,77,185,490,7.68047337278106,0.432967032967033,0.666666666666667,0.429844097995546,0.657142857142857,2.89940828402367,FALSE,2,4
"Joe Kopicki",118,3,1187,137,278,3,11,134,267,155,191,111,203,314,84,37,8,75,150,432,10.0593220338983,0.492805755395683,0.272727272727273,0.50187265917603,0.81151832460733,3.66101694915254,FALSE,2,3
"Joey Graham",377,84,6117,857,1776,54,180,803,1596,471,578,272,786,1058,207,134,43,309,804,2239,16.2254641909814,0.482545045045045,0.3,0.503132832080201,0.814878892733564,5.93899204244032,FALSE,2,6
"John Morton",153,5,2149,240,621,15,74,225,547,220,277,60,127,187,374,105,24,214,188,715,14.0457516339869,0.386473429951691,0.202702702702703,0.411334552102377,0.794223826714801,4.67320261437909,FALSE,2,3
"John Salmons",1133,567,31181,4110,9476,1033,2760,3077,6716,2133,2646,549,2820,3369,2802,985,308,1527,2139,11386,27.5207413945278,0.433727311101731,0.374275362318841,0.458159618820727,0.806122448979592,10.0494263018535,FALSE,2,13
"John Wallace",381,45,6143,1152,2496,15,50,1137,2446,582,786,328,733,1061,281,134,216,470,706,2901,16.1233595800525,0.461538461538462,0.3,0.464840556009812,0.740458015267176,7.61417322834646,FALSE,2,7
"John Williams",435,87,10952,1769,3921,65,289,1704,3632,803,1140,632,1569,2201,1262,566,184,684,1020,4406,25.1770114942529,0.451160418260648,0.224913494809689,0.469162995594714,0.704385964912281,10.1287356321839,FALSE,2,8
"Johnny Newman",1240,530,30132,4769,10335,624,1876,4145,8459,3410,4209,1036,1680,2716,1760,1133,273,1746,3395,13572,24.3,0.461441702951137,0.332622601279318,0.490010639555503,0.810168686148729,10.9451612903226,FALSE,2,16
"Jonathan Bender",262,28,3847,509,1221,101,297,408,924,334,438,153,429,582,170,43,169,258,391,1453,14.6832061068702,0.416871416871417,0.34006734006734,0.441558441558442,0.762557077625571,5.54580152671756,FALSE,2,8
"Jordan Hamilton",211,33,3119,489,1215,207,582,282,633,109,154,121,502,623,179,117,54,148,211,1294,14.781990521327,0.402469135802469,0.355670103092784,0.445497630331754,0.707792207792208,6.13270142180095,FALSE,2,5
"Josh Childress",391,70,10432,1343,2571,99,301,1244,2270,763,980,732,1118,1850,609,339,184,439,725,3548,26.6803069053708,0.522364838584208,0.32890365448505,0.548017621145374,0.778571428571429,9.07416879795396,FALSE,2,8
"Josh Howard",542,415,16268,2916,6549,365,1115,2551,5434,1519,1969,876,2135,3011,865,556,287,769,1388,7716,30.0147601476015,0.445258818140174,0.327354260089686,0.469451601030548,0.771457592686643,14.2361623616236,FALSE,2,10
"Jud Buechler",814,31,9418,1034,2410,284,779,750,1631,214,341,478,956,1434,615,354,159,325,816,2566,11.5700245700246,0.429045643153527,0.364569961489089,0.459840588595953,0.627565982404692,3.15233415233415,FALSE,2,12
"Julian Wright",231,40,3049,397,795,16,61,381,734,97,166,184,347,531,182,132,69,164,182,907,13.1991341991342,0.49937106918239,0.262295081967213,0.519073569482289,0.58433734939759,3.92640692640693,FALSE,2,4
"Jumaine Jones",471,115,9780,1294,3052,425,1218,869,1834,312,443,552,1435,1987,408,307,144,388,870,3325,20.7643312101911,0.423984272608126,0.348932676518883,0.473827699018539,0.704288939051919,7.05944798301486,FALSE,2,8
"Justin Reed",208,15,2433,293,726,0,5,293,721,211,285,129,181,310,109,54,34,131,382,797,11.6971153846154,0.403581267217631,0,0.406380027739251,0.740350877192982,3.83173076923077,FALSE,2,3
"K.J. McDaniels",259,31,3949,527,1278,133,457,394,821,288,372,176,430,606,180,133,182,285,380,1475,15.2471042471042,0.412363067292645,0.291028446389497,0.479902557856273,0.774193548387097,5.6949806949807,FALSE,2,3
"Karl Malone",1476,1471,54852,13528,26210,85,310,13443,25900,9787,13188,3562,11406,14968,5248,2085,1145,4524,4578,36928,37.1626016260163,0.516138878290729,0.274193548387097,0.519034749034749,0.742114043069457,25.0189701897019,TRUE,2,19
"Kedrick Brown",198,62,2904,320,755,84,267,236,488,74,116,139,354,493,167,115,35,93,250,798,14.6666666666667,0.423841059602649,0.314606741573034,0.483606557377049,0.637931034482759,4.03030303030303,FALSE,2,4
"Keith Askins",486,80,7983,677,1688,275,774,402,914,223,311,525,903,1428,375,278,170,321,1094,1852,16.4259259259259,0.4010663507109,0.355297157622739,0.439824945295405,0.717041800643087,3.81069958847737,FALSE,2,9
"Keith Bogans",808,379,17711,1816,4627,853,2438,963,2189,758,1052,477,1797,2274,1058,543,81,705,1495,5243,21.9195544554455,0.392478928031122,0.349876948318294,0.439926907263591,0.720532319391635,6.48886138613861,FALSE,2,11
"Keith Lee",182,43,2907,456,1012,2,12,454,1000,200,268,282,579,861,178,74,110,216,489,1114,15.9725274725275,0.450592885375494,0.166666666666667,0.454,0.746268656716418,6.12087912087912,FALSE,2,3
"Keith Van Horn",709,541,21992,4063,9126,744,2030,3319,7096,2194,2624,1360,3344,4704,1095,576,349,1512,2121,11064,31.0183356840621,0.445211483673022,0.366502463054187,0.467728297632469,0.836128048780488,15.605077574048,FALSE,2,9
"Kelenna Azubuike",208,84,5025,802,1748,210,514,592,1234,364,473,257,572,829,230,130,103,203,408,2178,24.1586538461538,0.458810068649886,0.408560311284047,0.479740680713128,0.769556025369979,10.4711538461538,FALSE,2,5
"Kelly Tripucka",707,575,20959,4434,9380,168,465,4266,8915,3106,3660,937,1766,2703,2090,678,137,1697,1634,12142,29.6449787835926,0.4727078891258,0.361290322580645,0.478519349411105,0.848633879781421,17.1739745403112,FALSE,2,10
"Ken Bannister",253,71,3867,586,1202,0,4,586,1198,329,669,276,617,893,111,109,80,347,669,1501,15.2845849802372,0.487520798668885,0,0.48914858096828,0.491778774289985,5.93280632411067,FALSE,2,5
"Ken Norman",646,441,18992,3737,7695,231,741,3506,6954,1012,1786,1352,2597,3949,1355,517,431,1173,1483,8717,29.3993808049536,0.485640025990903,0.311740890688259,0.504170261719873,0.566629339305711,13.4938080495356,FALSE,2,10
"Kendall Gill",1013,837,31164,5314,12196,341,1130,4973,11066,2601,3443,1346,2888,4234,3205,1583,456,1865,2646,13570,30.7640671273445,0.435716628402755,0.301769911504425,0.44939454183987,0.755445832123148,13.395853899309,FALSE,2,15
"Kennard Winchester",141,1,1109,185,444,14,43,171,401,68,87,63,83,146,54,30,27,49,120,452,7.86524822695035,0.416666666666667,0.325581395348837,0.42643391521197,0.781609195402299,3.20567375886525,FALSE,2,3
"Kenny Fields",232,38,3575,622,1329,6,28,616,1301,284,382,239,373,612,249,129,49,234,517,1534,15.4094827586207,0.468021068472536,0.214285714285714,0.47348193697156,0.743455497382199,6.61206896551724,FALSE,2,4
"Kenny Gattison",494,130,9927,1536,2956,1,12,1535,2944,850,1309,744,1583,2327,444,290,327,602,1419,3923,20.0951417004049,0.519621109607578,0.0833333333333333,0.521399456521739,0.649350649350649,7.9412955465587,FALSE,2,9
"Kenny Green",101,0,1078,191,454,0,2,191,452,84,117,60,114,174,25,14,20,85,114,466,10.6732673267327,0.420704845814978,0,0.422566371681416,0.717948717948718,4.61386138613861,FALSE,2,2
"Kenny Payne",144,13,1167,218,532,17,58,201,474,55,64,45,125,170,61,38,22,67,129,508,8.10416666666667,0.409774436090226,0.293103448275862,0.424050632911392,0.859375,3.52777777777778,FALSE,2,4
"Kenny Thomas",771,506,21451,2936,6306,60,247,2876,6059,1519,2139,1816,3589,5405,1239,656,321,1301,1977,7451,27.822308690013,0.465588328575959,0.242914979757085,0.474665786433405,0.710144927536232,9.66407263294423,FALSE,2,11
"Kenny Walker",448,160,9050,1240,2556,7,34,1233,2522,641,856,742,1051,1793,299,235,299,351,1184,3128,20.2008928571429,0.485133020344288,0.205882352941176,0.488897700237906,0.748831775700935,6.98214285714286,FALSE,2,7
"Kenny Williams",260,7,2918,547,1070,0,14,547,1056,153,225,315,378,693,161,76,166,136,366,1247,11.2230769230769,0.511214953271028,0,0.517992424242424,0.68,4.79615384615385,FALSE,2,4
"Kevin Brooks",126,2,1031,172,429,12,60,160,369,61,71,40,101,141,48,18,6,69,84,417,8.18253968253968,0.400932400932401,0.2,0.43360433604336,0.859154929577465,3.30952380952381,FALSE,2,3
"Kevin Gamble",714,283,15833,2714,5485,272,748,2442,4737,840,1038,391,1179,1570,1400,505,184,630,1375,6540,22.1750700280112,0.494804010938924,0.363636363636364,0.515516149461685,0.809248554913295,9.15966386554622,FALSE,2,10
"Kevin Loder",159,26,2231,384,834,7,26,377,808,148,213,120,236,356,188,70,48,154,277,923,14.0314465408805,0.460431654676259,0.269230769230769,0.466584158415842,0.694835680751174,5.80503144654088,FALSE,2,3
"Kevin McHale",971,400,30118,6830,12334,41,157,6789,12177,3634,4554,2358,4764,7122,1670,344,1690,1893,2758,17335,31.0175077239959,0.553753851143181,0.261146496815287,0.557526484355753,0.797979797979798,17.8527291452111,TRUE,2,13
"Kiki Vandeweghe",855,NA,25455,6339,12125,237,640,6102,11485,3564,4086,919,1937,2856,1737,487,254,1351,1638,16479,29.7719298245614,0.52280412371134,0.3703125,0.531301697866783,0.872246696035242,19.2736842105263,FALSE,2,13
"Kirk Snyder",247,89,4301,585,1305,97,304,488,1001,327,464,182,435,617,305,106,84,258,383,1594,17.412955465587,0.448275862068966,0.319078947368421,0.487512487512487,0.704741379310345,6.45344129554656,FALSE,2,4
"Kobe Bryant",1346,1198,48637,11719,26200,1827,5546,9892,20654,8378,10011,1499,5548,7047,6306,1944,640,4010,3353,33643,36.1344725111441,0.447290076335878,0.329426613775694,0.478938704367193,0.836879432624113,24.9947994056464,TRUE,2,20
"Korn√©l D√°vid",168,16,2268,293,659,0,7,293,652,204,249,152,287,439,88,69,31,136,256,790,13.5,0.444613050075873,0,0.449386503067485,0.819277108433735,4.70238095238095,FALSE,2,3
"Kris Humphries",922,220,16288,2379,5189,89,297,2290,4892,1333,1900,1564,3346,4910,624,378,525,795,1695,6180,17.6659436008677,0.458469840046252,0.2996632996633,0.468111201962388,0.701578947368421,6.70281995661605,FALSE,2,13
"Kurt Rambis",1026,524,19025,2059,3878,0,19,2059,3859,1124,1642,1873,3840,5713,1119,904,511,1179,2366,5242,18.5428849902534,0.530943785456421,0,0.533557916558694,0.684531059683313,5.10916179337232,FALSE,2,14
"Lamar Odom",961,684,32131,4811,10393,664,2126,4147,8267,2495,3599,1821,6238,8059,3554,848,892,2253,2916,12781,33.4349635796046,0.462907726354277,0.312323612417686,0.501632998669408,0.693248124479022,13.2996878251821,FALSE,2,14
"Lamond Murray",736,364,18477,3137,7301,528,1466,2609,5835,1484,1955,936,2097,3033,978,684,319,1207,1471,8286,25.1046195652174,0.429667168880975,0.360163710777626,0.447129391602399,0.759079283887468,11.258152173913,FALSE,2,11
"Landry Fields",255,176,6010,684,1446,120,361,564,1085,243,365,248,844,1092,419,212,45,270,310,1731,23.5686274509804,0.473029045643154,0.332409972299169,0.519815668202765,0.665753424657534,6.78823529411765,FALSE,2,5
"LaPhonso Ellis",624,359,17616,2895,6409,241,797,2654,5612,1379,1888,1320,2712,4032,981,433,477,1001,1934,7410,28.2307692307692,0.451708534872835,0.302383939774153,0.472915181753386,0.730402542372881,11.875,FALSE,2,11
"Laron Profit",135,18,1537,173,413,21,89,152,324,74,104,52,157,209,166,70,25,116,138,441,11.3851851851852,0.418886198547215,0.235955056179775,0.469135802469136,0.711538461538462,3.26666666666667,FALSE,2,4
"Larry Hughes",977,639,29306,4863,12091,738,2347,4125,9744,2882,3786,929,2990,3919,2932,1430,329,2011,2141,13346,29.9959058341863,0.402199983458771,0.314443971026843,0.423337438423645,0.761225567881669,13.6601842374616,FALSE,2,13
"Larry Krystkowiak",420,134,9097,1294,2830,5,36,1289,2794,832,1046,643,1408,2051,513,264,62,522,1048,3425,21.6595238095238,0.457243816254417,0.138888888888889,0.4613457408733,0.795411089866157,8.1547619047619,FALSE,2,9
"Larry Micheaux",153,0,1462,231,404,0,6,231,398,79,125,164,235,399,79,61,53,93,196,541,9.55555555555556,0.571782178217822,0,0.580402010050251,0.632,3.5359477124183,FALSE,2,2
"Larry Nance",987,855,33080,6857,12584,10,61,6847,12523,3243,4282,2492,5467,7959,2600,935,2186,1866,2945,16967,33.515704154002,0.544898283534647,0.163934426229508,0.54675397269025,0.757356375525455,17.1904761904762,FALSE,2,13
"Larry Robinson",159,22,2259,282,732,94,251,188,481,80,117,113,192,305,153,100,7,118,202,738,14.2075471698113,0.385245901639344,0.374501992031873,0.390852390852391,0.683760683760684,4.64150943396226,FALSE,2,7
"Larry Smith",883,NA,22879,2519,4743,0,7,2519,4736,866,1630,3401,4724,8125,941,699,457,1280,2966,5904,25.9105322763307,0.531098460889732,0,0.531883445945946,0.531288343558282,6.68629671574179,FALSE,2,13
"Larry Spriggs",169,39,2202,341,659,0,6,341,653,191,254,125,259,384,218,80,28,209,338,873,13.0295857988166,0.517450682852807,0,0.522205206738132,0.751968503937008,5.16568047337278,FALSE,2,5
"Larry Stewart",270,72,5415,765,1503,9,44,756,1459,466,619,444,633,1077,338,147,106,346,580,2005,20.0555555555556,0.508982035928144,0.204545454545455,0.518163125428376,0.752827140549273,7.42592592592593,FALSE,2,5
"Latrell Sprewell",913,868,35270,6076,14294,1104,3272,4972,11022,3456,4298,770,2954,3724,3664,1294,399,2450,1689,16712,38.630887185104,0.425073457394711,0.337408312958435,0.451097804391218,0.80409492787343,18.3044906900329,FALSE,2,13
"Lawrence Funderburke",318,7,4726,812,1606,2,17,810,1589,405,600,447,695,1142,183,94,100,225,360,2031,14.8616352201258,0.50560398505604,0.117647058823529,0.509754562617999,0.675,6.38679245283019,FALSE,2,7
"Lee Nailon",363,100,6600,1268,2693,1,12,1267,2681,426,540,443,636,1079,336,148,61,365,689,2963,18.1818181818182,0.470850352766432,0.0833333333333333,0.472584856396867,0.788888888888889,8.16253443526171,FALSE,2,6
"Linas Kleiza",409,65,8185,1268,2912,387,1154,881,1758,638,836,388,1082,1470,321,159,73,409,886,3561,20.0122249388753,0.43543956043956,0.335355285961872,0.501137656427759,0.763157894736842,8.70660146699267,FALSE,2,7
"Linton Johnson",205,34,2753,313,753,47,146,266,607,92,132,207,430,637,85,97,76,135,350,765,13.4292682926829,0.415670650730412,0.321917808219178,0.438220757825371,0.696969696969697,3.73170731707317,FALSE,2,6
"Lionel Simmons",454,307,13472,2242,5179,43,141,2199,5038,1306,1694,798,2035,2833,1498,514,361,982,1106,5833,29.6740088105727,0.432902104653408,0.304964539007092,0.436482731242557,0.770956316410862,12.8480176211454,FALSE,2,7
"Lou Amundson",550,77,7090,811,1751,0,4,811,1747,331,760,827,1171,1998,278,200,389,399,1078,1953,12.8909090909091,0.463163906339235,0,0.464224384659416,0.435526315789474,3.55090909090909,FALSE,2,10
"Louis Orr",569,NA,13353,2125,4539,3,36,2122,4503,1292,1642,903,1214,2117,853,455,163,788,1133,5545,23.4674868189807,0.468164794007491,0.0833333333333333,0.471241394625805,0.786845310596833,9.74516695957821,FALSE,2,8
"Loy Vaught",740,355,17542,3141,6243,21,86,3120,6157,849,1182,1533,3521,5054,675,531,235,848,1698,7152,23.7054054054054,0.503123498318116,0.244186046511628,0.506740295598506,0.718274111675127,9.66486486486487,FALSE,2,11
"Luis Scola",743,505,19001,3669,7442,92,271,3577,7171,1452,1961,1335,3606,4941,1194,474,224,1121,2037,8882,25.5733512786003,0.493012631013169,0.339483394833948,0.498814670199414,0.740438551759307,11.9542395693136,FALSE,2,10
"Luke Harangody",119,1,1511,181,477,37,153,144,324,47,64,100,239,339,66,36,37,36,177,446,12.6974789915966,0.379454926624738,0.241830065359477,0.444444444444444,0.734375,3.74789915966387,FALSE,2,2
"Luke Walton",594,138,10049,1074,2514,189,578,885,1936,367,513,494,1143,1637,1352,318,103,624,851,2704,16.9175084175084,0.427207637231504,0.326989619377163,0.457128099173554,0.715399610136452,4.55218855218855,FALSE,2,10
"Maceo Baston",105,4,831,106,172,3,8,103,164,71,96,56,119,175,26,24,43,54,140,286,7.91428571428571,0.616279069767442,0.375,0.628048780487805,0.739583333333333,2.72380952380952,FALSE,2,4
"Malik Allen",587,142,8877,1280,2869,4,18,1276,2851,302,378,572,1076,1648,290,158,273,383,1099,2866,15.1226575809199,0.446148483792262,0.222222222222222,0.447562258856542,0.798941798941799,4.8824531516184,FALSE,2,10
"Malik Rose",927,90,15349,2035,4676,15,96,2020,4580,1582,2129,1312,2496,3808,779,543,312,1197,2176,5667,16.5577130528587,0.435201026518392,0.15625,0.441048034934498,0.743071864725223,6.11326860841424,FALSE,2,13
"Malik Sealy",493,253,11720,1865,4375,158,541,1707,3834,1067,1319,505,1080,1585,816,518,157,681,1087,4955,23.7728194726166,0.426285714285714,0.292051756007394,0.445226917057903,0.808946171341926,10.0507099391481,FALSE,2,8
"Marc Iavaroni",668,373,10719,1171,2557,0,23,1171,2534,693,989,723,1515,2238,715,252,252,830,1635,3035,16.0464071856287,0.457958545170121,0,0.462115232833465,0.700707785642063,4.5434131736527,FALSE,2,7
"Marcus Fizer",289,35,6032,1103,2536,21,110,1082,2426,555,803,375,965,1340,352,134,81,428,648,2782,20.8719723183391,0.43493690851735,0.190909090909091,0.446001648804617,0.691158156911582,9.62629757785467,FALSE,2,6
"Marcus Liberty",305,63,4853,823,2000,76,222,747,1778,329,506,444,542,986,261,200,77,288,529,2051,15.9114754098361,0.4115,0.342342342342342,0.420134983127109,0.650197628458498,6.72459016393443,FALSE,2,4
"Marcus Williams",227,10,3170,439,1149,126,392,313,757,148,193,64,321,385,580,89,9,295,204,1152,13.9647577092511,0.38207136640557,0.321428571428571,0.413474240422721,0.766839378238342,5.07488986784141,FALSE,2,4
"Mardy Collins",237,45,3661,401,1025,51,158,350,867,140,233,122,321,443,438,141,32,261,336,993,15.4472573839662,0.391219512195122,0.322784810126582,0.403690888119954,0.600858369098712,4.18987341772152,FALSE,2,4
"Mario Elie",765,395,19298,2202,4651,578,1582,1624,3069,1520,1781,566,1561,2127,1920,690,139,990,1523,6502,25.2261437908497,0.473446570629972,0.365360303413401,0.529162593678723,0.853453116226839,8.49934640522876,FALSE,2,11
"Mark Aguirre",1003,715,30327,7787,16135,443,1432,7344,14703,3952,5337,1850,3114,4964,3149,732,332,2514,2828,19969,30.2362911266201,0.482615432290053,0.309357541899441,0.499489900020404,0.740490912497658,19.9092721834497,FALSE,2,13
"Mark Alarie",325,41,5500,1037,2184,34,135,1003,2049,324,418,438,682,1120,363,132,109,309,712,2432,16.9230769230769,0.47481684981685,0.251851851851852,0.489507076622743,0.77511961722488,7.48307692307692,FALSE,2,5
"Mark Davis",296,37,4197,571,1275,30,134,541,1141,343,506,323,448,771,322,226,85,348,559,1515,14.1790540540541,0.447843137254902,0.223880597014925,0.474145486415425,0.677865612648221,5.11824324324324,FALSE,2,5
"Mark Hendrickson",129,8,1579,139,330,3,18,136,312,113,141,101,228,329,69,52,16,66,147,394,12.2403100775194,0.421212121212121,0.166666666666667,0.435897435897436,0.801418439716312,3.05426356589147,FALSE,2,4
"Mark Pope",153,57,1634,116,289,10,56,106,233,43,75,92,169,261,63,32,45,47,242,285,10.6797385620915,0.401384083044983,0.178571428571429,0.454935622317597,0.573333333333333,1.86274509803922,FALSE,2,6
"Mark Randall",218,0,1572,236,518,10,63,226,455,118,166,145,141,286,100,40,13,95,167,600,7.21100917431193,0.455598455598456,0.158730158730159,0.496703296703297,0.710843373493976,2.75229357798165,FALSE,2,4
"Mark Strickland",336,28,4134,642,1344,3,11,639,1333,246,371,322,610,932,126,95,132,197,393,1533,12.3035714285714,0.477678571428571,0.272727272727273,0.479369842460615,0.663072776280323,4.5625,FALSE,2,8
"Marko Jariƒá",447,221,11246,1190,2944,289,840,901,2104,524,718,274,926,1200,1600,583,128,708,967,3193,25.158836689038,0.404211956521739,0.344047619047619,0.428231939163498,0.729805013927577,7.14317673378076,FALSE,2,7
"Marquis Daniels",548,146,11707,1772,3933,103,439,1669,3494,672,932,521,1031,1552,966,509,137,644,882,4319,21.3631386861314,0.450546656496313,0.234624145785877,0.477676016027476,0.721030042918455,7.88138686131387,FALSE,2,10
"Martell Webster",580,266,13914,1696,4062,790,2067,906,1995,874,1105,352,1459,1811,588,299,160,536,1055,5056,23.9896551724138,0.41752831117676,0.382196419932269,0.454135338345865,0.790950226244344,8.71724137931034,FALSE,2,10
"Martin M√º√ºrsepp",125,7,1299,191,453,24,86,167,367,139,207,116,132,248,70,53,36,65,212,545,10.392,0.421633554083885,0.27906976744186,0.455040871934605,0.671497584541063,4.36,FALSE,2,2
"Matt Barnes",1059,382,24375,3043,7001,1072,3209,1971,3792,1133,1520,1184,3602,4786,1914,782,477,1309,2638,8291,23.0169971671388,0.434652192543922,0.334060454970396,0.519778481012658,0.745394736842105,7.82908404154863,FALSE,2,14
"Matt Bullard",615,79,8884,1215,2907,599,1561,616,1346,241,314,278,945,1223,535,186,119,319,775,3270,14.4455284552846,0.417956656346749,0.383728379244074,0.457652303120357,0.767515923566879,5.31707317073171,FALSE,2,11
"Matt Harpring",665,349,17584,2900,6033,158,474,2742,5559,1687,2239,1281,2085,3366,907,497,112,1000,1748,7645,26.4421052631579,0.480689540858611,0.333333333333333,0.493254182406908,0.753461366681554,11.4962406015038,FALSE,2,11
"Maurice Evans",710,194,14187,1868,4200,562,1548,1306,2652,574,731,703,1055,1758,546,374,112,351,1227,4872,19.9816901408451,0.444761904761905,0.363049095607235,0.492458521870287,0.785225718194254,6.86197183098592,FALSE,2,9
"Metta World Peace",1102,946,35289,5285,12769,1285,3825,4000,8944,2914,4105,1307,3698,5005,2961,1984,602,2040,2967,14769,32.0226860254083,0.413893022163051,0.335947712418301,0.447227191413238,0.709866017052375,13.4019963702359,FALSE,2,17
"Michael Ansley",159,6,2188,391,764,0,0,391,764,265,366,313,314,627,69,51,24,88,291,1047,13.7610062893082,0.511780104712042,NA,0.511780104712042,0.724043715846995,6.58490566037736,FALSE,2,3
"Michael Brooks",319,NA,9372,1673,3445,5,33,1668,3412,735,1029,826,1175,2001,818,387,124,638,981,4086,29.3793103448276,0.485631349782293,0.151515151515152,0.488862837045721,0.714285714285714,12.8087774294671,FALSE,2,6
"Michael Curry",713,270,13991,1167,2609,99,318,1068,2291,764,934,225,905,1130,831,357,68,483,1615,3197,19.6227208976157,0.447297815254887,0.311320754716981,0.466171977302488,0.817987152034261,4.48387096774194,FALSE,2,11
"Michael Finley",1232,936,41495,7252,16350,1587,4242,5665,12108,2666,3292,1215,4032,5247,3512,1074,353,1814,1983,18757,33.6810064935065,0.443547400611621,0.374115983026874,0.467872481004295,0.809842041312272,15.2248376623377,FALSE,2,15
"Michael Jordan",1072,1039,41011,12192,24537,581,1778,11611,22759,7327,8772,1668,5004,6672,5633,2514,893,2924,2783,32292,38.2565298507463,0.49688225944492,0.326771653543307,0.510171800166967,0.835271317829457,30.1231343283582,TRUE,2,15
"Michael Redd",629,429,20104,4207,9405,1045,2751,3162,6654,2513,2998,622,1789,2411,1338,579,66,963,1002,11972,31.9618441971383,0.447315257841574,0.379861868411487,0.475202885482417,0.83822548365577,19.033386327504,FALSE,2,12
"Michael Smith",638,213,12933,1337,2581,10,68,1327,2513,792,1407,1316,2395,3711,891,423,268,686,1351,3476,20.2711598746082,0.518016272762495,0.147058823529412,0.528054118583366,0.562899786780384,5.44827586206897,FALSE,2,7
"Micka√´l Gelabale",145,27,2348,263,560,43,136,220,424,101,124,107,223,330,115,50,35,92,186,670,16.1931034482759,0.469642857142857,0.316176470588235,0.518867924528302,0.814516129032258,4.62068965517241,FALSE,2,3
"Micka√´l Pi√©trus",614,176,13057,1768,4186,764,2146,1004,2040,739,1110,455,1394,1849,478,400,251,615,1371,5039,21.2654723127036,0.422360248447205,0.35601118359739,0.492156862745098,0.665765765765766,8.20684039087948,FALSE,2,10
"Mike Harper",123,NA,1894,240,506,0,4,240,502,133,238,155,277,432,71,78,102,124,302,613,15.3983739837398,0.474308300395257,0,0.47808764940239,0.558823529411765,4.98373983739837,FALSE,2,2
"Mike McGee",568,136,10274,2310,4816,359,1025,1951,3791,564,919,597,643,1240,700,423,55,695,1093,5543,18.0880281690141,0.479651162790698,0.350243902439024,0.514639936692166,0.613710554951034,9.75880281690141,FALSE,2,9
"Mike Miller",1097,622,29998,4389,9606,1699,4210,2690,5396,1507,1943,678,4039,4717,2836,615,250,1686,2216,11984,27.3454876937101,0.456901936289819,0.403562945368171,0.498517420311342,0.77560473494596,10.9243391066545,FALSE,2,17
"Mike O'Koren",407,NA,8810,1449,2960,35,129,1414,2831,422,648,489,902,1391,856,311,89,541,894,3355,21.6461916461916,0.489527027027027,0.271317829457364,0.499470151889792,0.651234567901235,8.24324324324324,FALSE,2,8
"Mike Sanders",738,245,13907,2412,4963,20,90,2392,4873,904,1175,745,1387,2132,989,519,225,803,1889,5748,18.8441734417344,0.485996373161394,0.222222222222222,0.490868048430125,0.76936170212766,7.78861788617886,FALSE,2,11
"Monty Williams",487,109,7808,1170,2443,4,37,1166,2406,608,913,521,815,1336,552,257,139,572,923,2952,16.0328542094456,0.478919361440851,0.108108108108108,0.484621778886118,0.665936473165389,6.06160164271047,FALSE,2,9
"Morris Peterson",711,488,19366,2747,6567,1009,2702,1738,3865,1125,1456,569,1914,2483,1090,639,136,716,1606,7628,27.2376933895921,0.418303639409167,0.373427091043671,0.4496765847348,0.772664835164835,10.7285513361463,FALSE,2,11
"Nando De Colo",166,12,1908,233,547,67,188,166,359,97,114,51,233,284,268,85,18,151,183,630,11.4939759036145,0.425959780621572,0.356382978723404,0.462395543175487,0.850877192982456,3.79518072289157,FALSE,2,2
"Nick Anderson",800,636,24922,4416,9891,1055,2964,3361,6927,1642,2461,1011,3053,4064,2087,1114,364,1358,1502,11529,31.1525,0.446466484683045,0.355937921727395,0.485202829507723,0.667208451848842,14.41125,FALSE,2,13
"Nikoloz Tskitishvili",224,16,2265,225,737,46,203,179,534,97,136,130,240,370,127,55,63,151,268,593,10.1116071428571,0.305291723202171,0.226600985221675,0.335205992509363,0.713235294117647,2.64732142857143,FALSE,2,4
"Orlando Woolridge",909,532,25596,5439,10636,8,97,5431,10539,3435,4678,1448,2433,3881,1724,580,596,1826,2288,14321,28.1584158415842,0.51137645731478,0.0824742268041237,0.515324034538381,0.734288157332193,15.7546754675468,FALSE,2,13
"Otis Smith",447,120,9269,1865,4046,60,228,1805,3818,1002,1311,730,933,1663,845,468,230,666,964,4792,20.7360178970917,0.46094908551656,0.263157894736842,0.472760607647983,0.764302059496567,10.7203579418345,FALSE,2,6
"P.J. Hairston",177,106,3313,377,1085,189,645,188,440,131,164,72,368,440,97,85,35,104,335,1074,18.7175141242938,0.347465437788018,0.293023255813953,0.427272727272727,0.798780487804878,6.06779661016949,FALSE,2,2
"Pace Mannion",226,4,2157,261,631,16,81,245,550,130,196,88,176,264,233,110,21,135,243,668,9.54424778761062,0.413629160063391,0.197530864197531,0.445454545454545,0.663265306122449,2.95575221238938,FALSE,2,6
"Pat Garrity",552,107,11062,1479,3543,631,1587,848,1956,428,531,343,1114,1457,443,246,104,417,1274,4017,20.0398550724638,0.417442845046571,0.39760554505356,0.433537832310838,0.806026365348399,7.27717391304348,FALSE,2,10
"Paul Pierce",1343,1285,45880,8668,19465,2143,5816,6525,13649,6918,8578,1092,6435,7527,4708,1752,745,3532,3643,26397,34.162323157111,0.445312098638582,0.368466299862448,0.478057000512858,0.806481697365353,19.6552494415488,TRUE,2,19
"Paul Pressey",724,420,19659,2855,5890,79,356,2776,5534,1875,2503,901,1897,2798,3715,997,428,1700,2032,7664,27.1533149171271,0.48471986417657,0.221910112359551,0.501626310083123,0.749101078705553,10.585635359116,FALSE,2,11
"Paul Thompson",203,72,4047,757,1774,23,111,734,1663,290,366,261,430,691,302,197,104,217,479,1827,19.935960591133,0.426719278466742,0.207207207207207,0.441371016235719,0.792349726775956,9,FALSE,2,3
"Peja Stojakoviƒá",908,749,30184,5370,11964,1979,4932,3391,7032,2498,2785,840,3432,4272,1573,805,118,1210,1593,15217,33.2422907488987,0.448846539618857,0.401257096512571,0.482224118316268,0.896947935368043,16.7588105726872,FALSE,2,13
"Perry Jones",143,21,1675,195,464,36,123,159,341,62,94,46,206,252,54,36,33,60,135,488,11.7132867132867,0.420258620689655,0.292682926829268,0.466275659824047,0.659574468085106,3.41258741258741,FALSE,2,3
"Pete Chilcutt",716,81,10360,1300,2943,197,535,1103,2408,267,386,838,1599,2437,601,335,259,484,1090,3064,14.4692737430168,0.441726129799524,0.368224299065421,0.458056478405316,0.691709844559586,4.27932960893855,FALSE,2,9
"Pete Verhoeven",282,27,3220,432,856,1,4,431,852,135,196,272,369,641,152,128,67,166,622,1000,11.4184397163121,0.504672897196262,0.25,0.505868544600939,0.688775510204082,3.54609929078014,FALSE,2,6
"Popeye Jones",535,304,12579,1574,3523,25,89,1549,3434,553,736,1623,2358,3981,696,300,161,603,1501,3726,23.5121495327103,0.446778313936986,0.280898876404494,0.451077460687245,0.751358695652174,6.96448598130841,FALSE,2,11
"Pops Mensah-Bonsu",103,0,912,116,292,0,4,116,288,99,162,154,174,328,20,27,28,69,145,331,8.85436893203883,0.397260273972603,0,0.402777777777778,0.611111111111111,3.21359223300971,FALSE,2,4
"Quentin Richardson",783,486,20785,2923,7360,1167,3288,1756,4072,1019,1420,933,2733,3666,1138,607,148,868,1529,8032,26.5453384418902,0.397146739130435,0.35492700729927,0.431237721021611,0.717605633802817,10.2579821200511,FALSE,2,13
"Quincy Lewis",159,21,1853,232,584,37,111,195,473,66,93,71,139,210,96,59,36,98,335,567,11.6540880503145,0.397260273972603,0.333333333333333,0.412262156448203,0.709677419354839,3.56603773584906,FALSE,2,4
"Quinton Ross",510,176,9020,804,1935,53,175,751,1760,294,416,284,712,996,443,276,135,228,923,1955,17.6862745098039,0.415503875968992,0.302857142857143,0.426704545454545,0.706730769230769,3.83333333333333,FALSE,2,7
"Qyntel Woods",167,24,2060,281,621,35,98,246,523,94,156,107,278,385,105,71,28,138,226,691,12.3353293413174,0.452495974235105,0.357142857142857,0.470363288718929,0.602564102564103,4.1377245508982,FALSE,2,4
"Rafael Addison",379,54,5697,920,2047,69,245,851,1802,277,359,262,518,780,339,148,83,284,671,2186,15.0316622691293,0.449438202247191,0.281632653061224,0.472253052164262,0.77158774373259,5.76781002638522,FALSE,2,6
"Ralph Lewis",106,0,698,93,222,1,4,92,218,52,91,60,64,124,29,26,7,47,70,239,6.58490566037736,0.418918918918919,0.25,0.422018348623853,0.571428571428571,2.25471698113208,FALSE,2,3
"Randolph Keys",321,37,4933,815,1907,54,190,761,1717,279,387,310,494,804,280,203,53,259,747,1963,15.3676012461059,0.427372836916623,0.28421052631579,0.443214909726267,0.72093023255814,6.11526479750779,FALSE,2,5
"Randy White",281,66,5382,783,1951,27,140,756,1811,490,693,531,835,1366,175,209,127,372,861,2083,19.153024911032,0.401332649923116,0.192857142857143,0.417448923246825,0.707070707070707,7.41281138790036,FALSE,2,5
"Randy Wittman",607,275,12714,1953,3922,20,59,1933,3863,399,534,213,627,840,1312,280,67,473,602,4325,20.9456342668863,0.497960224375319,0.338983050847458,0.500388299249288,0.747191011235955,7.12520593080725,FALSE,2,9
"Rashard Lewis",1106,894,35365,5896,13061,1874,4869,4022,8192,2581,3207,1489,4234,5723,1857,1167,571,1664,2589,16247,31.9755877034358,0.451420258785698,0.384883959745328,0.490966796875,0.80480199563455,14.6898734177215,FALSE,2,16
"Rasual Butler",856,268,17989,2372,5923,957,2656,1415,3267,613,823,307,1704,2011,685,296,423,552,1169,6314,21.0151869158878,0.400472733412122,0.360316265060241,0.433119069482706,0.744835965978129,7.37616822429907,FALSE,2,13
"Ray Tolbert",423,4,4762,688,1385,0,11,688,1374,226,418,366,666,1032,228,117,169,359,693,1602,11.25768321513,0.496750902527076,0,0.500727802037846,0.54066985645933,3.78723404255319,FALSE,2,5
"Reggie Evans",930,417,17864,1309,2797,1,12,1308,2785,1261,2383,2270,4331,6601,517,643,128,1040,2180,3880,19.2086021505376,0.468001430103683,0.0833333333333333,0.469658886894075,0.529164918170373,4.17204301075269,FALSE,2,13
"Reggie Johnson",459,NA,9424,1663,3280,2,12,1661,3268,646,891,679,1301,1980,406,187,272,597,1402,3974,20.5315904139434,0.507012195121951,0.166666666666667,0.508261933904529,0.725028058361392,8.65795206971678,FALSE,2,4
"Reggie Lewis",450,352,14676,3198,6550,27,135,3171,6415,1479,1794,577,1361,1938,1153,569,417,708,1268,7902,32.6133333333333,0.48824427480916,0.2,0.494310210444271,0.824414715719064,17.56,FALSE,2,6
"Reggie Slater",278,44,3632,523,1079,0,2,523,1077,456,726,345,447,792,148,94,60,254,517,1502,13.0647482014388,0.484708063021316,0,0.48560817084494,0.628099173553719,5.40287769784173,FALSE,2,8
"Reggie Williams",938,491,22588,4135,9430,644,2026,3491,7404,1579,2013,1056,2250,3306,1989,1043,479,1362,2549,10493,24.0810234541578,0.438494167550371,0.31786771964462,0.4715018908698,0.784401390958768,11.1865671641791,FALSE,2,10
"Renaldo Balkman",229,12,3126,374,734,12,66,362,668,150,275,280,496,776,134,168,106,135,436,910,13.6506550218341,0.509536784741144,0.181818181818182,0.541916167664671,0.545454545454545,3.97379912663755,FALSE,2,6
"Richard Dumas",102,47,2226,434,852,3,13,431,839,209,301,160,191,351,111,137,47,150,228,1080,21.8235294117647,0.509389671361502,0.230769230769231,0.513706793802145,0.694352159468439,10.5882352941176,FALSE,2,3
"Richard Hamilton",921,783,29559,5969,13288,530,1530,5439,11758,3240,3805,794,2058,2852,3125,714,131,1977,2329,15708,32.0944625407166,0.449202287778447,0.34640522875817,0.46257866984181,0.851511169513798,17.0553745928339,FALSE,2,14
"Richie Frahm",173,2,1815,217,533,118,337,99,196,58,73,39,158,197,104,41,12,43,152,610,10.4913294797688,0.407129455909944,0.350148367952522,0.505102040816326,0.794520547945205,3.52601156069364,FALSE,2,4
"Rick Fox",930,587,23723,3382,7519,771,2208,2611,5311,1431,1858,996,2521,3517,2649,967,355,1611,2739,8966,25.5086021505376,0.4497938555659,0.349184782608696,0.49162116362267,0.770182992465016,9.64086021505376,FALSE,2,13
"Ricky Davis",893,449,27608,4777,10664,708,1996,4069,8668,2306,2967,708,2551,3259,3079,919,226,2008,1791,12568,30.9160134378499,0.447955738934734,0.354709418837675,0.469427780341486,0.77721604314122,14.073908174692,FALSE,2,12
"Robert Horry",1161,509,28464,2977,7003,844,2483,2133,4520,1340,1852,1712,3794,5506,2453,1224,1090,1450,2833,8138,24.5167958656331,0.425103527059832,0.33991139750302,0.471902654867257,0.72354211663067,7.00947459086994,FALSE,2,16
"Rod Higgins",809,203,17521,2522,5442,353,1039,2169,4403,1712,2122,960,1910,2870,1278,494,370,799,1761,7109,21.6576019777503,0.463432561558251,0.339749759384023,0.492618669089257,0.806786050895382,8.78739184177998,FALSE,2,13
"Rodney Buford",230,38,4182,630,1530,74,247,556,1283,138,182,117,481,598,179,115,31,140,332,1472,18.1826086956522,0.411764705882353,0.299595141700405,0.43335931410756,0.758241758241758,6.4,FALSE,2,5
"Rodney Carney",326,49,4936,721,1709,217,629,504,1080,246,351,177,459,636,143,171,105,173,453,1905,15.1411042944785,0.421884142773552,0.344992050874404,0.466666666666667,0.700854700854701,5.84355828220859,FALSE,2,5
"Rodney McCray",768,629,24876,3516,6997,57,219,3459,6778,1925,2529,1645,3442,5087,2750,585,493,1419,1734,9014,32.390625,0.502501071887952,0.26027397260274,0.51032753024491,0.761170423092131,11.7369791666667,FALSE,2,10
"Rodney Rogers",1001,388,25120,4136,9200,826,2389,3310,6811,1731,2483,1465,3010,4475,1920,975,500,1825,3076,10829,25.0949050949051,0.449565217391304,0.345751360401842,0.485978564087506,0.697140555779299,10.8181818181818,FALSE,2,12
"Rodney White",276,23,4031,738,1744,115,350,623,1394,242,331,137,437,574,281,150,76,322,373,1833,14.6050724637681,0.423165137614679,0.328571428571429,0.446915351506456,0.731117824773414,6.64130434782609,FALSE,2,4
"Roger Mason",544,106,9475,1228,3031,607,1588,621,1443,322,372,79,849,928,703,200,81,390,745,3385,17.4172794117647,0.405146816232267,0.382241813602015,0.43035343035343,0.865591397849462,6.22242647058824,FALSE,2,10
"Ron Anderson",762,111,17144,3281,6953,114,401,3167,6552,1183,1475,1002,1637,2639,1113,534,99,822,1160,7859,22.498687664042,0.471882640586797,0.28428927680798,0.483363858363858,0.802033898305085,10.3136482939633,FALSE,2,10
"Ron Grandison",133,6,1183,106,266,8,38,98,228,99,140,93,125,218,71,43,8,63,139,319,8.89473684210526,0.398496240601504,0.210526315789474,0.429824561403509,0.707142857142857,2.3984962406015,FALSE,2,4
"Ron Mercer",553,387,17511,3261,7667,93,350,3168,7317,1160,1443,497,1273,1770,1207,563,149,922,1140,7775,31.6654611211573,0.425329333507239,0.265714285714286,0.432964329643296,0.803880803880804,14.0596745027125,FALSE,2,8
"Ronald Dupree",162,8,1779,219,513,5,13,214,500,116,206,117,230,347,101,58,29,90,252,559,10.9814814814815,0.426900584795322,0.384615384615385,0.428,0.563106796116505,3.45061728395062,FALSE,2,6
"Ronnie Brewer",644,394,14294,1836,3811,122,470,1714,3341,843,1273,540,1228,1768,1042,762,142,463,662,4637,22.195652173913,0.481763316714773,0.259574468085106,0.513020053876085,0.662215239591516,7.20031055900621,FALSE,2,8
"Rory White",360,83,5782,1051,2089,1,13,1050,2076,470,699,387,436,823,247,202,55,354,551,2573,16.0611111111111,0.503111536620393,0.0769230769230769,0.505780346820809,0.67238912732475,7.14722222222222,FALSE,2,5
"Roshown McLeod",148,70,3052,483,1159,7,67,476,1092,181,217,129,299,428,182,64,22,198,288,1154,20.6216216216216,0.416738567730802,0.104477611940299,0.435897435897436,0.834101382488479,7.7972972972973,FALSE,2,3
"Roy Hinson",584,448,18135,3229,6498,0,14,3229,6484,1926,2583,1215,2754,3969,594,375,1022,1178,2163,8384,31.0530821917808,0.496922129886119,0,0.49799506477483,0.745644599303136,14.3561643835616,FALSE,2,8
"Roy Rogers",152,50,2415,297,621,1,2,296,619,77,147,188,312,500,59,29,217,106,286,672,15.8881578947368,0.478260869565217,0.5,0.478190630048465,0.523809523809524,4.42105263157895,FALSE,2,3
"Ruben Patterson",720,267,17747,3005,5815,36,209,2969,5606,1765,2774,1398,1543,2941,1277,827,270,1316,1568,7811,24.6486111111111,0.51676698194325,0.172248803827751,0.529611130931145,0.636265320836337,10.8486111111111,FALSE,2,10
"Rudy Macklin",160,52,2752,392,874,0,7,392,867,246,317,203,261,464,121,82,30,207,431,1030,17.2,0.448512585812357,0,0.452133794694348,0.77602523659306,6.4375,FALSE,2,3
"Russ Schoene",367,17,4770,828,1863,63,189,765,1674,248,332,380,610,990,234,146,94,309,765,1967,12.9972752043597,0.444444444444444,0.333333333333333,0.456989247311828,0.746987951807229,5.35967302452316,FALSE,2,4
"Ryan Bowen",507,85,6502,544,1192,14,68,530,1124,217,313,506,554,1060,250,325,138,168,752,1319,12.8244575936884,0.456375838926175,0.205882352941176,0.47153024911032,0.693290734824281,2.60157790927022,FALSE,2,10
"Ryan Gomes",487,371,13463,1891,4249,334,956,1557,3293,810,1014,617,1622,2239,712,351,78,550,942,4926,27.6447638603696,0.44504589315133,0.349372384937238,0.472821135742484,0.798816568047337,10.1149897330595,FALSE,2,8
"Ryan Humphrey",133,2,1216,113,347,0,3,113,344,64,115,120,168,288,29,29,37,71,188,290,9.14285714285714,0.325648414985591,0,0.328488372093023,0.556521739130435,2.18045112781955,FALSE,2,3
"Ryan Kelly",163,59,3125,324,857,102,323,222,534,231,290,77,427,504,215,79,84,106,309,981,19.1717791411043,0.37806301050175,0.31578947368421,0.415730337078652,0.796551724137931,6.01840490797546,FALSE,2,4
"Sam Mack",303,120,6111,880,2165,416,1098,464,1067,307,366,123,505,628,391,199,41,253,553,2483,20.1683168316832,0.406466512702079,0.378870673952641,0.434864104967198,0.83879781420765,8.1947194719472,FALSE,2,7
"Sam Mitchell",994,322,22257,3220,7206,65,292,3155,6914,2131,2719,1251,2460,3711,1089,548,301,838,2509,8636,22.3913480885312,0.446849847349431,0.222602739726027,0.456320509111947,0.783744023538065,8.68812877263582,FALSE,2,13
"Sam Young",284,54,4341,605,1393,54,192,551,1201,286,386,183,452,635,195,151,63,220,334,1550,15.2852112676056,0.434314429289304,0.28125,0.458784346378018,0.740932642487047,5.45774647887324,FALSE,2,4
"≈†ar≈´nas Marƒçiulionis",363,30,8123,1571,3109,127,344,1444,2765,1362,1773,292,527,819,807,459,31,715,971,4631,22.3774104683196,0.505307172724349,0.369186046511628,0.522242314647378,0.768189509306261,12.7575757575758,TRUE,2,7
"Sasha Pavloviƒá",598,149,9250,1099,2723,320,921,779,1802,345,514,189,843,1032,533,282,105,472,1060,2863,15.4682274247492,0.403598971722365,0.347448425624321,0.432297447280799,0.671206225680934,4.7876254180602,FALSE,2,10
"Scott Burrell",440,124,8531,1069,2592,380,1025,689,1567,423,582,444,1046,1490,601,369,199,390,985,2941,19.3886363636364,0.412422839506173,0.370731707317073,0.439693682195278,0.72680412371134,6.68409090909091,FALSE,2,8
"Scott Padgett",479,18,5844,695,1714,248,677,447,1037,282,388,418,863,1281,333,187,89,262,716,1920,12.2004175365344,0.405484247374562,0.366322008862629,0.431051108968177,0.72680412371134,4.00835073068894,FALSE,2,8
"Scott Roth",223,9,2334,307,828,26,95,281,733,292,405,81,187,268,241,111,16,176,319,932,10.4663677130045,0.370772946859903,0.273684210526316,0.383356070941337,0.720987654320988,4.17937219730942,FALSE,2,3
"Scottie Pippen",1178,1053,41069,7420,15700,978,3002,6442,12698,3122,4437,2068,5426,7494,6135,2307,947,3257,3329,18940,34.8633276740238,0.472611464968153,0.325782811459027,0.507323988029611,0.703628577867929,16.0780984719864,TRUE,2,17
"Sean Elliott",742,712,24502,3852,8290,589,1572,3263,6718,2251,2816,819,2385,3204,1897,576,284,1328,1626,10544,33.0215633423181,0.464656212303981,0.374681933842239,0.485710032747842,0.799360795454545,14.2102425876011,FALSE,2,12
"Sean Higgins",258,39,3950,686,1582,99,315,587,1267,195,229,144,360,504,267,89,38,280,409,1666,15.3100775193798,0.433628318584071,0.314285714285714,0.463299131807419,0.851528384279476,6.45736434108527,FALSE,2,6
"Shandon Anderson",785,231,17117,2094,4583,312,1001,1782,3582,1082,1458,624,1819,2443,1077,596,194,1008,1575,5582,21.8050955414013,0.456905956796858,0.311688311688312,0.49748743718593,0.742112482853224,7.11082802547771,FALSE,2,10
"Shane Battier",1059,764,32379,3211,7328,1352,3521,1859,3807,1258,1699,1363,3092,4455,1902,1057,987,957,2366,9032,30.5750708215297,0.43818231441048,0.38398182334564,0.488311006041503,0.74043555032372,8.52880075542965,FALSE,2,13
"Shavlik Randolph",173,7,1381,144,340,1,11,143,329,89,163,174,241,415,41,50,42,65,218,378,7.98265895953757,0.423529411764706,0.0909090909090909,0.434650455927052,0.54601226993865,2.1849710982659,FALSE,2,8
"Shawn Marion",1295,1192,44882,8071,16631,867,2641,7204,13990,2554,3174,3048,8285,11333,2475,1972,1384,1941,2817,19563,34.6579150579151,0.485298538873189,0.32828474062855,0.51493924231594,0.80466288594833,15.1065637065637,FALSE,2,16
"Shawne Williams",377,80,6455,771,1912,339,990,432,922,229,297,283,828,1111,264,152,177,227,791,2110,17.1220159151194,0.403242677824268,0.342424242424242,0.468546637744035,0.771043771043771,5.59681697612732,FALSE,2,7
"Sonny Weems",226,47,3834,556,1216,49,161,507,1055,135,196,95,360,455,306,94,29,239,315,1296,16.9646017699115,0.457236842105263,0.304347826086957,0.480568720379147,0.688775510204082,5.73451327433628,FALSE,2,4
"Stacey Augmon",1061,482,22600,3142,6700,12,79,3130,6621,1973,2713,1351,2003,3354,1617,1016,334,1312,1837,8269,21.3006597549482,0.468955223880597,0.151898734177215,0.472738257060867,0.727239218577221,7.79359095193214,FALSE,2,15
"Stephen Graham",261,43,3090,399,902,55,182,344,720,171,220,82,369,451,124,62,21,168,383,1024,11.8390804597701,0.442350332594235,0.302197802197802,0.477777777777778,0.777272727272727,3.92337164750958,FALSE,2,6
"Stephen Howard",169,0,1202,177,347,0,0,177,347,158,249,100,158,258,36,57,40,85,208,512,7.11242603550296,0.510086455331412,NA,0.510086455331412,0.634538152610442,3.02958579881657,FALSE,2,4
"Stephen Jackson",1061,840,34218,5772,13899,1530,4637,4242,9262,3191,4001,835,3279,4114,3339,1379,407,2686,2539,16265,32.2507068803016,0.415281674940643,0.329954712098339,0.458000431872166,0.797550612346913,15.3298774740811,FALSE,2,14
"Steve Novak",542,6,6113,816,1858,627,1446,189,412,109,125,74,572,646,146,92,45,91,411,2368,11.2785977859779,0.439181916038751,0.433609958506224,0.45873786407767,0.872,4.3690036900369,FALSE,2,11
"Tayshaun Prince",1157,999,35604,5119,11304,638,1711,4481,9593,1682,2228,1249,3657,4906,2695,648,541,1188,1392,12558,30.7726879861711,0.452848549186129,0.372881355932203,0.467111435421662,0.754937163375224,10.8539325842697,FALSE,2,14
"Tellis Frank",264,81,4703,639,1456,0,4,639,1452,432,583,363,659,1022,276,158,95,326,795,1710,17.8143939393939,0.438873626373626,0,0.440082644628099,0.740994854202401,6.47727272727273,FALSE,2,5
"Terence Morris",139,12,1934,209,514,22,112,187,402,32,45,123,254,377,93,35,49,81,126,472,13.9136690647482,0.406614785992218,0.196428571428571,0.465174129353234,0.711111111111111,3.39568345323741,FALSE,2,3
"Terrence Williams",204,9,3762,565,1374,80,251,485,1123,194,299,84,614,698,467,112,26,298,259,1404,18.4411764705882,0.411208151382824,0.318725099601594,0.431878895814782,0.648829431438127,6.88235294117647,FALSE,2,4
"Terry Catledge",515,379,13541,2576,5311,3,32,2573,5279,1365,2087,1479,1835,3314,459,285,99,886,1285,6520,26.2932038834951,0.485031067595556,0.09375,0.48740291721917,0.654048873981792,12.6601941747573,FALSE,2,8
"Terry Cummings",1257,818,35083,8245,17056,44,150,8201,16906,3393,4809,3280,5633,8913,2237,1293,660,2251,4017,19927,27.9101034208433,0.483407598499062,0.293333333333333,0.485094049449899,0.705552089831566,15.8528241845664,FALSE,2,18
"Terry Mills",733,305,17241,2981,6515,533,1391,2448,5124,995,1280,1111,2798,3909,924,432,325,894,1996,7490,23.5211459754434,0.457559478127398,0.383177570093458,0.477751756440281,0.77734375,10.2182810368349,FALSE,2,11
"Terry Teagle",708,196,14858,3369,7227,32,147,3337,7080,1387,1754,748,1098,1846,970,530,132,1020,1568,8157,20.9858757062147,0.466168534661685,0.217687074829932,0.471327683615819,0.790763968072976,11.521186440678,FALSE,2,11
"Thomas Robinson",437,16,6058,904,1942,0,9,904,1933,361,706,759,1366,2125,269,234,157,466,774,2169,13.862700228833,0.465499485066941,0,0.467666839110191,0.511331444759207,4.96338672768879,FALSE,2,5
"Thurl Bailey",1012,247,26977,5121,10892,4,37,5117,10855,2539,3133,1426,3777,5203,1376,470,1203,1552,2003,12785,26.6571146245059,0.470161586485494,0.108108108108108,0.471395670198065,0.810405362272582,12.6333992094862,FALSE,2,12
"Tim Breaux",102,6,940,108,293,22,74,86,219,61,96,38,58,96,41,24,13,47,68,299,9.2156862745098,0.368600682593857,0.297297297297297,0.392694063926941,0.635416666666667,2.93137254901961,FALSE,2,3
"Tim Kempton",301,20,3941,475,1000,0,3,475,997,352,523,255,570,825,319,128,48,304,646,1302,13.093023255814,0.475,0,0.476429287863591,0.673040152963671,4.32558139534884,FALSE,2,8
"Tim Thomas",1033,515,26150,4255,9714,1180,3171,3075,6543,1937,2572,984,3173,4157,1530,746,350,1482,2786,11627,25.3146176185866,0.438027589046737,0.372122358877326,0.469967904630903,0.753110419906687,11.2555663117135,FALSE,2,13
"Tom Chambers",1107,743,33922,7378,15749,227,740,7151,15009,5066,6274,1942,4761,6703,2283,885,627,2549,3742,20049,30.643179765131,0.468474188837387,0.306756756756757,0.476447464854421,0.807459356072681,18.1111111111111,FALSE,2,16
"Tom Gugliotta",942,707,27909,4411,9865,277,948,4134,8917,2172,2893,1881,4658,6539,2550,1283,583,2020,2272,11271,29.6273885350318,0.447136340598074,0.292194092827004,0.46360883705282,0.750777739370895,11.9649681528662,FALSE,2,13
"Tom Hammonds",741,65,11132,1515,3161,0,12,1515,3149,835,1216,771,1599,2370,402,185,148,563,1321,3865,15.0229419703104,0.479278709269219,0,0.481105112734201,0.686677631578947,5.21592442645074,FALSE,2,12
"Tom Tolbert",312,120,5680,757,1647,29,98,728,1549,487,680,406,845,1251,285,116,109,347,741,2030,18.2051282051282,0.459623557984214,0.295918367346939,0.469980632666236,0.716176470588235,6.50641025641026,FALSE,2,7
"Toni Kukoƒç",967,309,25593,4205,9437,845,2509,3360,6928,2106,2912,1157,2930,4087,3583,942,329,1801,1675,11361,26.4663908996898,0.445586521140193,0.336787564766839,0.484988452655889,0.723214285714286,11.7487073422958,TRUE,2,13
"Tony Brown",490,107,7320,1042,2416,62,230,980,2186,499,686,430,507,937,653,283,49,460,922,2645,14.9387755102041,0.431291390728477,0.269565217391304,0.448307410795974,0.727405247813411,5.39795918367347,FALSE,2,7
"Tony Campbell",753,238,16394,3407,7493,74,292,3333,7201,1661,2104,988,1315,2303,1101,632,172,1167,1670,8549,21.7715803452855,0.45469104497531,0.253424657534247,0.462852381613665,0.789448669201521,11.3532536520584,FALSE,2,11
"Tracy McGrady",968,727,31331,6800,15648,1097,3262,5703,12386,3929,5265,1322,4048,5370,4260,1151,821,2073,1701,18626,32.3667355371901,0.434560327198364,0.336296750459841,0.460439205554659,0.74624881291548,19.2417355371901,TRUE,2,15
"Tracy Moore",119,6,1729,298,738,77,224,221,514,160,191,75,108,183,121,62,8,98,186,833,14.5294117647059,0.403794037940379,0.34375,0.429961089494163,0.837696335078534,7,FALSE,2,5
"Tracy Murray",764,84,13207,2370,5551,824,2131,1546,3420,894,1083,547,1242,1789,550,387,172,664,1225,6458,17.2866492146597,0.426950099081247,0.386672923510089,0.452046783625731,0.825484764542936,8.45287958115183,FALSE,2,12
"Travis Outlaw",656,104,13756,2104,4994,384,1126,1720,3868,990,1324,513,1582,2095,548,349,398,544,1078,5582,20.969512195122,0.421305566680016,0.341030195381883,0.444674250258532,0.74773413897281,8.50914634146342,FALSE,2,11
"Tremaine Fowlkes",103,27,1233,105,257,4,20,101,237,87,110,94,134,228,54,47,6,50,146,301,11.9708737864078,0.408560311284047,0.2,0.426160337552743,0.790909090909091,2.92233009708738,FALSE,2,4
"Trenton Hassell",707,434,17051,1606,3615,97,308,1509,3307,555,726,561,1348,1909,1173,295,275,619,1489,3864,24.1173974540311,0.444260027662517,0.314935064935065,0.456304807983066,0.764462809917355,5.46534653465347,FALSE,2,9
"Trevor Wilson",160,26,2830,423,906,0,6,423,900,211,376,273,353,626,171,88,25,210,280,1057,17.6875,0.466887417218543,0,0.47,0.561170212765957,6.60625,FALSE,2,4
"Troy Murphy",832,534,22239,3156,7095,676,1758,2480,5337,1679,2152,1495,4740,6235,1237,539,339,984,2133,8667,26.7295673076923,0.444820295983087,0.38452787258248,0.464680532134158,0.780204460966543,10.4170673076923,FALSE,2,12
"Tyler Hansbrough",428,50,7233,947,2156,3,22,944,2134,984,1333,745,1063,1808,181,207,91,319,869,2881,16.8995327102804,0.439239332096475,0.136363636363636,0.442361761949391,0.738184546136534,6.73130841121495,FALSE,2,7
"Tyrone Corbin",1363,489,34057,4789,10471,203,695,4586,9776,2207,2774,2185,4142,6327,2330,1500,333,1644,3277,11988,24.986793837124,0.457358418489161,0.292086330935252,0.469108019639935,0.795602018745494,8.79530447542186,FALSE,2,16
"Tyrone Nesby",317,152,8215,1107,2801,240,784,867,2017,489,629,346,768,1114,446,315,113,334,822,2943,25.9148264984227,0.395215994287754,0.306122448979592,0.429846306395637,0.777424483306836,9.28391167192429,FALSE,2,4
"Viktor Khryapa",143,58,2351,251,567,14,48,237,519,127,193,168,324,492,142,86,48,139,353,643,16.4405594405594,0.442680776014109,0.291666666666667,0.456647398843931,0.658031088082902,4.4965034965035,FALSE,2,4
"Vladimir Radmanoviƒá",933,291,20474,2709,6559,1244,3291,1465,3268,768,1006,814,2728,3542,1260,673,314,1072,1970,7430,21.9442658092176,0.413020277481323,0.378000607718019,0.44828641370869,0.763419483101392,7.96355841371919,FALSE,2,12
"Von Wafer",229,14,2629,407,989,106,340,301,649,180,241,39,214,253,153,75,22,141,162,1100,11.4803493449782,0.411526794742164,0.311764705882353,0.463790446841294,0.746887966804979,4.80349344978166,FALSE,2,6
"Wally Szczerbiak",798,466,24517,4290,8927,782,1926,3508,7001,2060,2384,782,2350,3132,1849,451,191,1182,1633,11422,30.7230576441103,0.480564579365968,0.406022845275182,0.501071275532067,0.864093959731544,14.31328320802,FALSE,2,10
"Walt Williams",840,499,22457,3547,8365,1170,3087,2377,5278,1724,2313,913,2400,3313,1989,802,499,1564,2445,9988,26.7345238095238,0.424028690974298,0.379008746355685,0.450359984842743,0.745352356247298,11.8904761904762,FALSE,2,11
"Walter Berry",337,208,7804,1862,3494,2,10,1860,3484,766,1182,620,927,1547,474,189,239,646,965,4492,23.1572700296736,0.532913566113337,0.2,0.533869115958668,0.648054145516074,13.3293768545994,FALSE,2,3
"Walter Herrmann",197,12,2312,368,825,134,363,234,462,102,128,100,292,392,84,38,13,73,167,972,11.7360406091371,0.446060606060606,0.369146005509642,0.506493506493506,0.796875,4.93401015228426,FALSE,2,3
"Walter McCarty",665,108,11280,1187,3021,511,1473,676,1548,431,625,439,1253,1692,707,405,188,556,1355,3316,16.9624060150376,0.392916252896392,0.346911065852003,0.436692506459948,0.6896,4.98646616541353,FALSE,2,10
"Wayman Tisdale",919,569,26302,5870,11611,0,25,5870,11586,2519,3307,1804,3922,5726,1205,519,552,1579,3091,14259,28.620239390642,0.505555077082077,0,0.506645952011048,0.761717568793468,15.5157780195865,FALSE,2,12
"Wesley Person",832,457,22431,3361,7383,1246,2981,2115,4402,826,1062,442,2160,2602,1339,617,243,735,1033,8794,26.9603365384615,0.455234999322769,0.417980543441798,0.480463425715584,0.777777777777778,10.5697115384615,FALSE,2,11
"Willie Anderson",631,476,18034,3092,6612,133,492,2959,6120,1196,1516,598,1730,2328,2302,669,401,1306,1730,7513,28.5800316957211,0.467634603750756,0.270325203252033,0.483496732026144,0.788918205804749,11.9064976228209,FALSE,2,9
"Willie Burton",316,118,6666,1090,2569,140,406,950,2163,923,1174,326,606,932,393,191,121,517,846,3243,21.0949367088608,0.424289606850915,0.344827586206897,0.439204808136847,0.786201022146508,10.2626582278481,FALSE,2,8
"Winston Bennett",190,137,2990,337,815,0,2,337,813,169,243,240,336,576,158,69,30,148,427,843,15.7368421052632,0.413496932515337,0,0.414514145141451,0.695473251028807,4.43684210526316,FALSE,2,3
"Xavier Henry",185,23,2905,368,907,41,126,327,781,273,430,81,270,351,120,100,23,139,264,1050,15.7027027027027,0.405733186328556,0.325396825396825,0.418693982074264,0.634883720930233,5.67567567567568,FALSE,2,5
"Xavier McDaniel",951,608,27835,6263,12871,74,291,6189,12580,2379,3313,2255,3615,5870,1962,867,462,2071,2821,14979,29.2691903259727,0.486597777950431,0.254295532646048,0.491971383147854,0.718080289767582,15.7507886435331,FALSE,2,12
"Yakhouba Diawara",187,56,2614,233,653,122,405,111,248,67,103,77,181,258,122,52,16,72,276,655,13.9786096256684,0.356814701378254,0.301234567901235,0.44758064516129,0.650485436893204,3.50267379679144,FALSE,2,4
"Yi Jianlian",272,163,6038,813,2012,75,225,738,1787,447,573,379,960,1339,192,136,184,302,618,2148,22.1985294117647,0.404075546719682,0.333333333333333,0.412982652490207,0.780104712041885,7.89705882352941,FALSE,2,5
"≈Ωarko ƒåabarkapa",190,4,2025,320,725,37,124,283,601,201,267,133,281,414,110,43,30,149,280,878,10.6578947368421,0.441379310344828,0.298387096774194,0.470881863560732,0.752808988764045,4.62105263157895,FALSE,2,3
