"player","g","gs","mp","fg","fga","x3p","x3pa","x2p","x2pa","ft","fta","orb","drb","trb","ast","stl","blk","tov","pf","pts","mpg","fg_percent","x3p_percent","x2p_percent","ft_percent","pts_per_game","hof","pos","years"
"A.J. English",151,18,3108,617,1418,9,65,608,1353,259,333,140,175,315,320,57,24,203,287,1502,20.5827814569536,0.435119887165021,0.138461538461538,0.449371766444937,0.777777777777778,9.94701986754967,FALSE,1,2
"A.J. Price",287,25,4253,600,1581,233,747,367,834,223,303,74,335,409,613,132,9,243,252,1656,14.8188153310105,0.379506641366224,0.311914323962517,0.440047961630695,0.735973597359736,5.77003484320557,FALSE,1,6
"Acie Law",265,9,3345,379,898,38,167,341,731,257,334,48,227,275,419,126,5,205,270,1053,12.622641509434,0.422048997772829,0.227544910179641,0.466484268125855,0.769461077844311,3.97358490566038,FALSE,1,4
"Alexey Shved",224,34,4038,578,1542,209,668,369,874,418,540,108,346,454,566,140,55,291,249,1783,18.0267857142857,0.374837872892348,0.312874251497006,0.422196796338673,0.774074074074074,7.95982142857143,FALSE,1,3
"Allan Houston",839,727,28311,5337,12017,1305,3247,4032,8770,2572,2979,353,2081,2434,1990,566,139,1760,2062,14551,33.7437425506555,0.44412082882583,0.401909454881429,0.459749144811859,0.863376972138301,17.3432657926103,FALSE,1,12
"Allen Iverson",1064,1042,43303,9532,22369,1158,3704,8374,18665,7235,9256,814,3025,3839,6488,2213,185,3740,2006,27457,40.6983082706767,0.426125441459162,0.312634989200864,0.448647200642915,0.781655142610199,25.8054511278195,TRUE,1,14
"Alvin Robertson",848,734,26675,4659,9784,276,922,4383,8862,1906,2579,1728,2607,4335,4192,2267,341,2249,2856,11500,31.4563679245283,0.476185609157809,0.299349240780911,0.494583615436696,0.739046141915471,13.561320754717,FALSE,1,10
"Alvin Williams",514,347,13681,1789,4232,217,692,1572,3540,690,912,276,945,1221,1980,587,112,681,976,4485,26.6167315175097,0.42273156899811,0.313583815028902,0.44406779661017,0.756578947368421,8.72568093385214,FALSE,1,9
"Andre Barrett",124,2,1584,172,469,33,135,139,334,47,64,41,95,136,256,58,2,89,133,424,12.7741935483871,0.366737739872068,0.244444444444444,0.416167664670659,0.734375,3.41935483870968,FALSE,1,4
"Andre Miller",1562,1024,45930,6769,14640,218,986,6551,13654,4379,5444,1547,3934,5481,9717,1738,252,3545,3290,18135,29.404609475032,0.462363387978142,0.221095334685598,0.479786143254724,0.804371785451874,11.6101152368758,FALSE,1,17
"Andre Turner",181,4,2638,318,765,14,61,304,704,143,186,66,205,271,558,145,3,224,211,793,14.5745856353591,0.415686274509804,0.229508196721311,0.431818181818182,0.768817204301075,4.38121546961326,FALSE,1,6
"Andrew Toney",468,303,12608,2859,5718,138,403,2721,5315,1602,2010,235,774,1009,1965,369,105,1394,1341,7458,26.9401709401709,0.5,0.3424317617866,0.511947318908749,0.797014925373134,15.9358974358974,FALSE,1,8
"Anthony Bowie",461,87,8349,1247,2628,67,211,1180,2417,384,466,299,722,1021,840,288,106,478,711,2945,18.1106290672451,0.474505327245053,0.317535545023697,0.48820852296235,0.824034334763948,6.3882863340564,FALSE,1,8
"Anthony Carter",656,181,12647,1275,3149,128,504,1147,2645,441,621,251,1102,1353,2432,628,121,997,1152,3119,19.2789634146341,0.404890441409971,0.253968253968254,0.433648393194707,0.710144927536232,4.75457317073171,FALSE,1,13
"Anthony Goldwire",385,104,6846,784,1938,307,783,477,1155,393,497,95,420,515,1049,223,11,364,535,2268,17.7818181818182,0.404540763673891,0.392081736909323,0.412987012987013,0.790744466800805,5.89090909090909,FALSE,1,8
"Anthony Johnson",1038,324,19532,2121,5145,402,1115,1719,4030,814,1092,368,1323,1691,2887,692,114,1092,1643,5458,18.8169556840077,0.412244897959184,0.360538116591928,0.426550868486352,0.745421245421245,5.25818882466281,FALSE,1,13
"Anthony Morrow",654,150,13377,2118,4777,864,2113,1254,2664,662,750,332,944,1276,532,354,78,394,984,5762,20.454128440367,0.443374502826041,0.40889730241363,0.470720720720721,0.882666666666667,8.81039755351682,FALSE,1,9
"Anthony Peeler",865,328,21657,3291,7675,993,2570,2298,5105,911,1142,601,1658,2259,2093,836,144,1070,1767,8486,25.0369942196532,0.428794788273616,0.386381322957198,0.450146914789422,0.797723292469352,9.81040462427746,FALSE,1,13
"Antonio Daniels",946,229,20692,2369,5345,381,1214,1988,4131,1804,2273,224,1466,1690,3111,590,86,990,972,6923,21.8731501057082,0.443217960710945,0.313838550247117,0.481239409343985,0.793664760228773,7.31818181818182,FALSE,1,13
"Archie Goodwin",180,15,2610,403,922,50,206,353,716,294,415,93,266,359,230,73,43,220,200,1150,14.5,0.437093275488069,0.242718446601942,0.493016759776536,0.708433734939759,6.38888888888889,FALSE,1,4
"Avery Johnson",1259,679,30161,4117,8603,32,215,4085,8388,1792,2541,428,1549,1977,6628,1155,176,2008,1896,10058,23.9563145353455,0.478553992793212,0.148837209302326,0.487005245588937,0.705234159779614,7.98888006354249,FALSE,1,16
"B.J. Armstrong",845,342,18979,2995,6282,452,1076,2543,5206,1244,1454,210,1226,1436,2690,574,47,956,1233,7686,22.4603550295858,0.476758993950971,0.420074349442379,0.488474836726854,0.855570839064649,9.09585798816568,FALSE,1,11
"Baron Davis",939,768,31822,5468,13396,1531,4752,3937,8644,2625,3666,829,2685,3514,6778,1689,402,2585,2630,15092,33.8892438764643,0.408181546730367,0.322180134680135,0.455460434983804,0.716039279869067,16.0724174653887,FALSE,1,13
"Bart Kofoed",111,0,702,58,150,3,16,55,134,43,70,16,40,56,108,19,4,56,95,162,6.32432432432432,0.386666666666667,0.1875,0.41044776119403,0.614285714285714,1.45945945945946,FALSE,1,5
"Ben Gordon",744,269,20366,3931,9092,1171,2921,2760,6171,2051,2394,333,1518,1851,1868,508,114,1551,1720,11084,27.3736559139785,0.432358117025957,0.400890106128038,0.44725328147788,0.85672514619883,14.8978494623656,FALSE,1,11
"Beno Udrih",982,298,20992,3114,6774,533,1522,2581,5252,1134,1362,360,1624,1984,3392,654,79,1387,1466,7895,21.3767820773931,0.45969884853853,0.350197109067017,0.491431835491241,0.832599118942731,8.03971486761711,FALSE,1,13
"Bimbo Coles",968,420,23625,2923,6936,347,1229,2576,5707,1481,1829,529,1610,2139,3807,846,155,1466,2137,7674,24.4059917355372,0.421424452133795,0.282343368592351,0.451375503767303,0.809732094040459,7.92768595041322,FALSE,1,14
"Bo Kimble",105,22,1336,217,562,25,86,192,476,115,158,58,104,162,98,41,14,98,205,574,12.7238095238095,0.386120996441281,0.290697674418605,0.403361344537815,0.727848101265823,5.46666666666667,FALSE,1,3
"Bob Hansen",643,327,11913,1721,3690,172,538,1549,3152,511,782,425,934,1359,1016,386,53,590,1333,4125,18.5272161741835,0.46639566395664,0.319702602230483,0.491434010152284,0.653452685421995,6.41524105754277,FALSE,1,9
"Bob Sura",737,223,17260,2120,5113,444,1382,1676,3731,1566,2250,686,1880,2566,2707,703,156,1336,1635,6250,23.4192672998643,0.414629376100137,0.321273516642547,0.449209327258108,0.696,8.48032564450475,FALSE,1,10
"Bobby Hurley",330,65,5045,454,1261,69,257,385,1004,305,396,65,284,349,1057,143,7,471,439,1282,15.2878787878788,0.360031720856463,0.268482490272374,0.383466135458167,0.77020202020202,3.88484848484848,FALSE,1,5
"Bobby Jackson",827,148,18179,2959,7107,770,2173,2189,4934,1209,1525,656,1872,2528,2084,749,73,1073,1468,7897,21.9818621523579,0.41635007738849,0.354348826507133,0.443656262667207,0.792786885245902,9.54897218863362,FALSE,1,12
"Bobby Phills",467,379,13426,1957,4416,342,878,1615,3538,897,1215,411,1058,1469,1246,592,139,711,1106,5153,28.7494646680942,0.443161231884058,0.389521640091116,0.456472583380441,0.738271604938272,11.03426124197,FALSE,1,9
"Brandon Armstrong",108,0,699,101,287,25,75,76,212,12,20,22,41,63,24,22,4,37,83,239,6.47222222222222,0.35191637630662,0.333333333333333,0.358490566037736,0.6,2.21296296296296,FALSE,1,3
"Brandon Roy",326,300,11561,2224,4849,322,925,1902,3924,1366,1707,347,1041,1388,1517,335,76,595,630,6136,35.4631901840491,0.458651268302743,0.348108108108108,0.484709480122324,0.800234329232572,18.8220858895706,FALSE,1,6
"Brent Price",418,80,7007,818,1918,363,938,455,980,482,585,175,509,684,1236,313,16,626,759,2481,16.7631578947368,0.426485922836288,0.386993603411514,0.464285714285714,0.823931623931624,5.93540669856459,FALSE,1,9
"Brevin Knight",838,479,20670,2263,5514,19,137,2244,5377,1391,1763,319,1746,2065,4996,1414,92,1530,2118,5936,24.6658711217184,0.410409865796155,0.138686131386861,0.417333085363586,0.788996029495179,7.0835322195704,FALSE,1,12
"Brian Oliver",118,4,1182,155,400,5,22,150,378,74,105,31,92,123,114,45,6,78,121,389,10.0169491525424,0.3875,0.227272727272727,0.396825396825397,0.704761904761905,3.29661016949153,FALSE,1,4
"Brian Quinnett",177,5,1856,244,609,41,127,203,482,60,91,106,169,275,88,57,33,88,191,589,10.4858757062147,0.400656814449918,0.322834645669291,0.421161825726141,0.659340659340659,3.32768361581921,FALSE,1,3
"Brian Roberts",365,59,5677,827,1996,232,652,595,1344,378,417,64,399,463,775,142,21,295,403,2264,15.5534246575342,0.414328657314629,0.355828220858896,0.442708333333333,0.906474820143885,6.2027397260274,FALSE,1,5
"Brian Shaw",1065,421,24619,2952,7378,464,1534,2488,5844,1046,1342,860,2742,3602,4429,853,291,1862,2212,7414,23.1164319248826,0.400108430468962,0.302477183833116,0.425735797399042,0.779433681073025,6.96150234741784,FALSE,1,14
"Brook Steppe",238,28,2858,443,945,9,29,434,916,402,490,127,218,345,280,105,17,248,334,1297,12.0084033613445,0.468783068783069,0.310344827586207,0.473799126637555,0.820408163265306,5.44957983193277,FALSE,1,5
"Brooks Thompson",265,14,2936,463,1141,255,670,208,471,83,131,49,220,269,488,152,8,257,377,1264,11.0792452830189,0.40578439964943,0.380597014925373,0.441613588110403,0.633587786259542,4.76981132075472,FALSE,1,4
"Bryan Warrick",205,31,3064,347,774,8,36,339,738,202,266,50,237,287,552,107,21,267,383,904,14.9463414634146,0.448320413436692,0.222222222222222,0.459349593495935,0.759398496240602,4.40975609756098,FALSE,1,4
"Bryant Stith",586,406,16417,2021,4767,306,931,1715,3836,1598,1900,605,1378,1983,1178,594,130,776,1092,5946,28.0153583617747,0.423956366687644,0.328678839957035,0.447080291970803,0.841052631578947,10.1467576791809,FALSE,1,10
"Bryce Drew",243,46,3970,419,1096,150,404,269,692,93,112,56,239,295,524,123,10,209,291,1081,16.3374485596708,0.382299270072993,0.371287128712871,0.388728323699422,0.830357142857143,4.44855967078189,FALSE,1,6
"Byron Scott",1073,717,30152,5918,12268,775,2093,5143,10175,2486,2985,677,2310,2987,2729,1224,276,1597,2051,15097,28.1006523765144,0.482393218128464,0.370281892021022,0.505454545454545,0.832830820770519,14.0698974836906,FALSE,1,14
"C.J. Watson",600,104,12093,1516,3617,471,1263,1045,2354,841,1036,218,938,1156,1485,559,67,650,894,4344,20.155,0.419131877246337,0.3729216152019,0.44392523364486,0.811776061776062,7.24,FALSE,1,10
"Carl Nicks",223,NA,3688,622,1332,0,14,622,1318,238,419,149,258,407,398,192,10,344,483,1482,16.5381165919283,0.466966966966967,0,0.471927162367223,0.568019093078759,6.6457399103139,FALSE,1,3
"Carl Thomas",106,0,960,126,316,43,132,83,184,34,53,23,84,107,47,45,15,43,88,329,9.0566037735849,0.39873417721519,0.325757575757576,0.451086956521739,0.641509433962264,3.10377358490566,FALSE,1,3
"Carlos Arroyo",817,251,14849,1935,4460,183,526,1752,3934,1048,1307,301,1041,1342,2468,404,36,953,1237,5101,18.1750305997552,0.433856502242152,0.347908745247148,0.44534824605999,0.801836266258607,6.24357405140759,FALSE,1,9
"Charles Bradley",110,6,910,127,305,0,4,127,301,93,159,42,77,119,55,46,34,87,151,347,8.27272727272727,0.416393442622951,0,0.421926910299003,0.584905660377358,3.15454545454545,FALSE,1,3
"Charles Jenkins",169,30,1775,228,533,5,24,223,509,58,83,24,108,132,258,63,10,102,129,519,10.5029585798817,0.427767354596623,0.208333333333333,0.43811394891945,0.698795180722892,3.07100591715976,FALSE,1,2
"Charlie Bell",383,137,9412,1195,2902,438,1219,757,1683,384,499,182,637,819,859,303,31,367,753,3212,24.5744125326371,0.411784975878704,0.359310910582445,0.449792038027332,0.769539078156313,8.38642297650131,FALSE,1,7
"Charlie Ward",701,295,15332,1560,3818,723,1960,837,1858,528,686,254,1538,1792,2754,840,139,1134,1383,4371,21.8716119828816,0.408590885280251,0.368877551020408,0.45048439181916,0.769679300291545,6.23537803138374,FALSE,1,11
"Chauncey Billups",1274,1158,40323,5767,13936,2245,5810,3522,8126,5524,6172,599,3012,3611,6843,1322,204,2666,2648,19303,31.6507064364207,0.413820321469575,0.386402753872633,0.433423578636476,0.8950097213221,15.1514913657771,FALSE,1,17
"Chris Childs",618,142,15476,1423,3531,404,1188,1019,2343,822,1005,220,1290,1510,2988,549,69,1220,1828,4072,25.042071197411,0.403001982441235,0.34006734006734,0.434912505335041,0.817910447761194,6.58899676375405,FALSE,1,9
"Chris Corchiani",122,1,1418,145,335,21,81,124,254,149,184,28,108,136,259,79,4,128,177,460,11.6229508196721,0.432835820895522,0.259259259259259,0.488188976377953,0.809782608695652,3.77049180327869,FALSE,1,3
"Chris Duhon",606,319,15526,1353,3440,649,1788,704,1652,591,754,200,1164,1364,2690,471,36,925,965,3946,25.6204620462046,0.393313953488372,0.362975391498881,0.426150121065375,0.783819628647215,6.51155115511551,FALSE,1,9
"Chris Quinn",241,26,3303,381,956,161,427,220,529,169,209,30,236,266,455,102,8,137,249,1092,13.7053941908714,0.398535564853557,0.377049180327869,0.415879017013232,0.808612440191388,4.53112033195021,FALSE,1,6
"Chris Robinson",111,6,1509,199,530,82,221,117,309,32,58,41,122,163,143,66,17,100,185,512,13.5945945945946,0.375471698113208,0.3710407239819,0.378640776699029,0.551724137931034,4.61261261261261,FALSE,1,2
"Chris Smith",226,39,3958,425,976,59,161,366,815,231,324,61,230,291,627,118,56,219,346,1140,17.5132743362832,0.435450819672131,0.366459627329193,0.449079754601227,0.712962962962963,5.04424778761062,FALSE,1,3
"Chris Whitney",630,186,11104,1351,3459,602,1692,749,1767,789,906,100,782,882,1758,380,34,690,1076,4093,17.6253968253968,0.390575310783463,0.355791962174941,0.423882286361064,0.870860927152318,6.4968253968254,FALSE,1,11
"Chucky Atkins",864,390,20973,2931,7192,1127,3137,1804,4055,1188,1534,231,1192,1423,2876,563,42,1220,1565,8177,24.2743055555556,0.407536151279199,0.359260439910743,0.444882860665845,0.774445893089961,9.46412037037037,FALSE,1,11
"Clinton Wheeler",115,0,1221,152,306,0,2,152,304,55,74,53,49,102,211,90,2,100,89,359,10.6173913043478,0.496732026143791,0,0.5,0.743243243243243,3.12173913043478,FALSE,1,2
"Clyde Drexler",1162,1025,40265,8906,18911,974,3011,7932,15900,5062,6404,2767,4390,7157,6487,2343,764,3163,3491,23848,34.6514629948365,0.470942837501983,0.323480571238791,0.498867924528302,0.790443472829482,20.5232358003442,TRUE,1,15
"Conner Henry",186,4,1512,216,572,66,174,150,398,112,148,40,126,166,204,42,12,130,142,610,8.12903225806452,0.377622377622378,0.379310344827586,0.376884422110553,0.756756756756757,3.27956989247312,FALSE,1,2
"Corey Beck",112,14,1131,111,245,4,6,107,239,60,91,42,111,153,143,52,11,100,160,286,10.0982142857143,0.453061224489796,0.666666666666667,0.447698744769874,0.659340659340659,2.55357142857143,FALSE,1,3
"Corey Benjamin",153,16,2191,317,812,57,197,260,615,144,221,84,175,259,143,71,48,164,316,835,14.3202614379085,0.390394088669951,0.289340101522843,0.422764227642276,0.65158371040724,5.45751633986928,FALSE,1,4
"Cory Alexander",367,57,6145,758,1908,303,845,455,1063,346,454,95,532,627,1043,333,48,579,612,2165,16.7438692098093,0.39727463312369,0.358579881656805,0.428033866415804,0.762114537444934,5.8991825613079,FALSE,1,7
"Courtney Alexander",252,83,5449,894,2125,58,167,836,1958,462,567,166,386,552,289,156,23,278,516,2308,21.6230158730159,0.420705882352941,0.347305389221557,0.426966292134831,0.814814814814815,9.15873015873016,FALSE,1,3
"Craig Ehlo",873,321,21071,2977,6579,621,1684,2356,4895,917,1330,996,2143,3139,2456,989,232,1225,1695,7492,24.1363115693013,0.45250037999696,0.368764845605701,0.481307456588355,0.689473684210526,8.58190148911798,FALSE,1,14
"Craig Hodges",820,262,17726,2808,6082,724,1763,2084,4319,758,914,348,756,1104,2068,642,32,949,1576,7098,21.6170731707317,0.46169023347583,0.410663641520136,0.482519101643899,0.829321663019694,8.65609756097561,FALSE,1,10
"Craig Neal",116,0,1125,104,281,23,77,81,204,41,68,16,58,74,273,52,8,127,166,272,9.69827586206897,0.370106761565836,0.298701298701299,0.397058823529412,0.602941176470588,2.3448275862069,FALSE,1,2
"Cuttino Mobley",813,645,30006,4727,10911,1235,3209,3492,7702,2409,2889,588,2543,3131,2203,952,343,1653,1862,13098,36.9077490774908,0.433232517642746,0.384855095045185,0.453388730199948,0.833852544132918,16.1107011070111,FALSE,1,11
"Dajuan Wagner",103,28,2202,354,967,92,287,262,680,164,213,29,113,142,195,69,14,136,212,964,21.378640776699,0.366080661840745,0.320557491289199,0.385294117647059,0.769953051643192,9.35922330097087,FALSE,1,4
"Damon Jones",736,115,14417,1640,4057,1007,2590,633,1467,397,548,133,1040,1173,1944,288,21,608,745,4684,19.5883152173913,0.404239585900912,0.388803088803089,0.431492842535787,0.724452554744526,6.36413043478261,FALSE,1,11
"Damon Stoudamire",1009,897,32982,4897,12090,1377,3917,3520,8173,2134,2565,810,2645,3455,6116,1096,90,2342,1931,13305,32.6878097125867,0.405045492142266,0.351544549400051,0.430686406460296,0.831968810916179,13.1863230921705,FALSE,1,13
"Dan Dickau",414,103,7001,951,2371,274,800,677,1571,551,663,116,495,611,1137,257,15,495,759,2727,16.9106280193237,0.401096583719949,0.3425,0.43093570973902,0.831070889894419,6.58695652173913,FALSE,1,6
"Dana Barros",850,264,19480,3281,7140,1090,2652,2191,4488,1249,1456,232,1377,1609,2837,740,46,1213,1074,8901,22.9176470588235,0.45952380952381,0.411010558069382,0.48819073083779,0.85782967032967,10.4717647058824,FALSE,1,14
"Daniel Ewing",127,8,1683,162,416,36,122,126,294,71,91,32,126,158,174,69,10,107,148,431,13.251968503937,0.389423076923077,0.295081967213115,0.428571428571429,0.78021978021978,3.39370078740157,FALSE,1,2
"Daniel Gibson",397,77,9316,1065,2646,578,1419,487,1227,407,522,142,650,792,775,243,86,373,811,3115,23.4659949622166,0.40249433106576,0.407329105003524,0.396903015484923,0.779693486590038,7.8463476070529,FALSE,1,7
"Danny Ainge",1115,562,30132,5123,10956,1118,2956,4005,8000,1881,2220,766,2257,3023,4601,1226,140,1711,2735,13245,27.0242152466368,0.467597663380796,0.378213802435724,0.500625,0.847297297297297,11.8789237668161,FALSE,1,14
"Danny Young",636,78,10559,1084,2508,217,664,867,1844,517,618,184,600,784,1846,553,41,519,589,2902,16.6022012578616,0.432216905901116,0.326807228915663,0.470173535791757,0.836569579288026,4.56289308176101,FALSE,1,10
"Darius Morris",159,17,1777,205,528,59,184,146,344,68,107,47,105,152,233,58,2,139,160,537,11.1761006289308,0.388257575757576,0.320652173913043,0.424418604651163,0.635514018691589,3.37735849056604,FALSE,1,4
"Darnell Valentine",682,374,15612,2154,4948,45,171,2109,4777,1503,1919,383,1060,1443,3326,982,60,1355,1481,5856,22.891495601173,0.435327405012126,0.263157894736842,0.441490475193636,0.783220427305888,8.58651026392962,FALSE,1,9
"Darrell Armstrong",906,353,20903,2752,6784,951,2874,1801,3910,1521,1747,689,1695,2384,3572,1178,106,1623,1490,7976,23.0717439293598,0.405660377358491,0.330897703549061,0.460613810741688,0.870635374928449,8.80353200883002,FALSE,1,14
"Darrell Griffith",765,NA,21403,5237,11305,530,1596,4707,9709,1387,1961,780,1739,2519,1627,931,242,1632,1689,12391,27.9777777777778,0.463246351172048,0.332080200501253,0.484807910186425,0.707292197858236,16.197385620915,FALSE,1,10
"Darrell Walker",757,358,19112,2503,5778,6,103,2497,5675,1457,2053,1079,2113,3192,3329,1123,227,1486,1890,6469,25.2470277410832,0.433194877120111,0.058252427184466,0.44,0.709693132001948,8.54557463672391,FALSE,1,10
"Darrick Martin",573,194,10314,1333,3470,370,1099,963,2371,904,1072,117,553,670,1692,393,25,738,1017,3940,18,0.384149855907781,0.336669699727025,0.406157739350485,0.843283582089552,6.8760907504363,FALSE,1,13
"Darwin Cook",678,NA,15299,2697,5953,63,321,2634,5632,870,1134,458,957,1415,2375,1115,213,1210,1436,6327,22.5648967551622,0.453048882916177,0.196261682242991,0.467684659090909,0.767195767195767,9.33185840707965,FALSE,1,8
"David Rivers",114,11,1286,139,349,1,12,138,337,104,131,53,94,147,282,61,10,166,117,383,11.280701754386,0.398280802292264,0.0833333333333333,0.409495548961424,0.793893129770992,3.35964912280702,FALSE,1,3
"David Wesley",1029,875,33046,4582,10863,1241,3366,3341,7497,2385,3016,564,2069,2633,4424,1376,170,1921,2525,12790,32.1146744412051,0.421798766454939,0.368686868686869,0.445644924636521,0.7907824933687,12.4295432458698,FALSE,1,14
"Dee Brown",767,301,19534,2854,6580,733,2044,2121,4536,1161,1418,365,1454,1819,2536,924,235,1043,1494,7602,25.4680573663625,0.433738601823708,0.358610567514677,0.467592592592593,0.818758815232722,9.91134289439374,FALSE,1,12
"Delaney Rudd",239,3,2357,317,768,45,175,272,593,137,180,45,139,184,519,74,4,250,244,816,9.86192468619247,0.412760416666667,0.257142857142857,0.458684654300169,0.761111111111111,3.41422594142259,FALSE,1,4
"Dell Curry",1083,99,23549,5090,11146,1245,3098,3845,8048,1245,1476,599,2018,2617,1909,985,238,1299,1795,12670,21.7442289935365,0.456666068544769,0.401872175597159,0.477758449304175,0.84349593495935,11.6989843028624,FALSE,1,16
"Delonte West",493,289,13375,1797,4046,424,1147,1373,2899,687,842,244,1214,1458,1769,524,208,819,931,4705,27.1298174442191,0.444142362827484,0.369659982563208,0.473611590203518,0.815914489311164,9.54361054766734,FALSE,1,8
"Derek Fisher",1383,783,34802,3904,9838,1313,3530,2591,6308,2117,2584,428,2388,2816,4021,1422,105,1576,2856,11238,25.1641359363702,0.396828623704005,0.371954674220963,0.410748256182625,0.819272445820433,8.12581344902386,FALSE,1,18
"Derek Harper",1281,938,39990,6494,14128,1143,3229,5351,10899,2666,3589,716,2309,3025,6911,2082,312,2469,2918,16797,31.2177985948478,0.459654586636467,0.353979560235367,0.490962473621433,0.74282529952633,13.1124121779859,FALSE,1,16
"Deron Williams",974,880,32987,5565,12539,1368,3847,4197,8692,3316,4023,407,2619,3026,7846,977,229,2770,2460,15814,33.8675564681725,0.44381529627562,0.355601767611126,0.482857800276116,0.824260502112851,16.2361396303901,FALSE,1,12
"Derrick Dial",114,0,986,144,397,9,53,135,344,57,82,59,130,189,98,31,15,51,64,354,8.64912280701754,0.36272040302267,0.169811320754717,0.392441860465116,0.695121951219512,3.10526315789474,FALSE,1,4
"Devin Brown",525,166,10175,1322,3323,358,1053,964,2270,779,1001,373,1057,1430,751,300,65,576,833,3781,19.3809523809524,0.397833283177851,0.339981006647673,0.424669603524229,0.778221778221778,7.20190476190476,FALSE,1,8
"Dion Glover",363,135,7775,1144,2811,188,586,956,2225,551,726,271,892,1163,585,283,84,472,610,3027,21.4187327823691,0.406972607612949,0.320819112627986,0.429662921348315,0.758953168044077,8.33884297520661,FALSE,1,6
"Dirk Minniefield",368,118,6471,819,1753,40,147,779,1606,279,383,161,442,603,1421,327,21,608,779,1957,17.5842391304348,0.46719908727895,0.272108843537415,0.48505603985056,0.72845953002611,5.3179347826087,FALSE,1,3
"Doc Rivers",927,605,24556,3403,7718,406,1228,2997,6490,2486,3175,649,2085,2734,5051,1628,372,1711,2810,9698,26.4897518878101,0.440917336097435,0.330618892508143,0.461787365177196,0.782992125984252,10.4617044228695,FALSE,1,13
"Donald Sloan",274,77,4681,555,1374,107,360,448,1014,236,311,75,475,550,794,101,11,293,247,1453,17.0839416058394,0.403930131004367,0.297222222222222,0.44181459566075,0.758842443729904,5.3029197080292,FALSE,1,5
"Doron Lamb",147,0,1849,183,486,64,164,119,322,69,104,24,117,141,107,37,1,79,158,499,12.578231292517,0.376543209876543,0.390243902439024,0.369565217391304,0.663461538461538,3.39455782312925,FALSE,1,2
"Doug Overton",605,84,9027,1067,2602,124,405,943,2197,436,539,167,633,800,1271,241,22,582,726,2694,14.9206611570248,0.410069177555726,0.306172839506173,0.429221665908056,0.808905380333952,4.45289256198347,FALSE,1,11
"Doug West",676,379,16649,2631,5473,37,194,2594,5279,1178,1470,532,1138,1670,1292,459,189,823,1862,6477,24.6286982248521,0.480723551982459,0.190721649484536,0.491380943360485,0.801360544217687,9.58136094674556,FALSE,1,12
"Dražen Petrović",351,149,8684,1948,3862,278,648,1670,3214,910,1083,291,488,779,787,308,28,677,883,5084,24.7407407407407,0.504401864319006,0.429012345679012,0.5196017423771,0.840258541089566,14.4843304843305,TRUE,1,4
"Earl Boykins",766,57,15477,2485,5944,490,1381,1995,4563,1495,1704,343,716,1059,2464,464,37,913,794,6955,20.2049608355091,0.41806864064603,0.354815351194786,0.437212360289283,0.877347417840376,9.07963446475196,FALSE,1,13
"Earl Watson",948,237,21072,2331,5648,612,1823,1719,3825,942,1344,486,1657,2143,4160,941,186,1684,1914,6216,22.2278481012658,0.412712464589235,0.335710367526056,0.449411764705882,0.700892857142857,6.55696202531646,FALSE,1,13
"Eddie Gill",201,10,2187,191,527,68,212,123,315,159,186,29,200,229,239,111,16,148,227,609,10.8805970149254,0.362428842504744,0.320754716981132,0.39047619047619,0.854838709677419,3.02985074626866,FALSE,1,7
"Eddie House",853,38,14513,2416,5898,940,2420,1476,3478,454,529,193,1222,1415,1293,554,71,651,1073,6226,17.0140679953107,0.409630383180739,0.388429752066116,0.424381828637148,0.858223062381853,7.2989449003517,FALSE,1,11
"Eldridge Recasner",302,47,5154,631,1484,239,585,392,899,236,266,131,403,534,527,130,12,306,407,1737,17.0662251655629,0.425202156334232,0.408547008547009,0.436040044493882,0.887218045112782,5.75165562913907,FALSE,1,8
"Elliot Perry",683,139,10727,1506,3317,150,420,1356,2897,658,850,215,646,861,1903,650,24,902,797,3820,15.705710102489,0.454024721133554,0.357142857142857,0.468070417673455,0.774117647058824,5.59297218155198,FALSE,1,10
"Elliot Williams",122,2,1589,207,495,62,192,145,303,98,149,38,131,169,106,49,6,82,170,574,13.0245901639344,0.418181818181818,0.322916666666667,0.478547854785479,0.657718120805369,4.70491803278689,FALSE,1,4
"Emanual Davis",226,62,3934,402,1020,156,443,246,577,140,178,79,361,440,396,167,29,267,344,1100,17.4070796460177,0.394117647058824,0.352144469525959,0.4263431542461,0.786516853932584,4.86725663716814,FALSE,1,6
"Ennis Whatley",399,194,7215,860,1840,3,31,857,1809,462,615,202,491,693,1777,388,45,697,721,2185,18.0827067669173,0.467391304347826,0.0967741935483871,0.473742399115533,0.751219512195122,5.47619047619048,FALSE,1,10
"Eric Maynor",443,4,6455,732,1872,179,521,553,1351,253,353,106,456,562,1260,182,34,474,483,1896,14.5711060948081,0.391025641025641,0.343570057581574,0.409326424870466,0.71671388101983,4.27990970654628,FALSE,1,5
"Eric Murdock",581,238,13555,2133,4897,341,1008,1792,3889,1158,1472,365,1065,1430,2794,965,78,1123,1121,5765,23.3304647160069,0.435572799673269,0.338293650793651,0.460786834661867,0.786684782608696,9.92254733218589,FALSE,1,9
"Eric Snow",910,551,24050,2223,5238,57,282,2166,4956,1497,1968,438,1784,2222,4422,1035,110,1454,2127,6000,26.4285714285714,0.424398625429553,0.202127659574468,0.437046004842615,0.760670731707317,6.59340659340659,FALSE,1,13
"Eric Washington",104,42,2300,274,682,81,234,193,448,87,115,82,134,216,108,78,43,106,230,716,22.1153846153846,0.401759530791789,0.346153846153846,0.430803571428571,0.756521739130435,6.88461538461539,FALSE,1,2
"Erick Strickland",551,122,11019,1414,3667,434,1246,980,2421,778,939,242,1203,1445,1298,466,43,716,1047,4040,19.9981851179673,0.385601308971912,0.348314606741573,0.404791408508881,0.828541001064963,7.33212341197822,FALSE,1,9
"Fat Lever",752,599,23814,4244,9504,162,523,4082,8981,1783,2312,1442,3081,4523,4696,1666,209,1471,1803,10433,31.6675531914894,0.446548821548822,0.309751434034417,0.454515087406748,0.771193771626298,13.873670212766,FALSE,1,11
"Felipe López",319,128,5710,761,1752,67,199,694,1553,409,611,267,571,838,359,223,92,337,607,1998,17.8996865203762,0.434360730593607,0.336683417085427,0.446877012234385,0.669394435351882,6.26332288401254,FALSE,1,4
"Frank Johnson",596,217,12897,1947,4433,53,243,1894,4190,990,1303,309,716,1025,2476,570,36,1054,1116,4937,21.6392617449664,0.439205955334988,0.218106995884774,0.452028639618138,0.759785111281658,8.28355704697987,FALSE,1,10
"Franklin Edwards",296,36,4436,738,1644,1,33,737,1611,325,409,78,222,300,774,249,21,398,348,1802,14.9864864864865,0.448905109489051,0.0303030303030303,0.45747982619491,0.794621026894866,6.08783783783784,FALSE,1,7
"Fred Hoiberg",541,61,9978,959,2227,373,941,586,1286,653,765,143,1295,1438,846,428,59,292,783,2944,18.4436229205176,0.430624158060171,0.396386822529224,0.455676516329705,0.85359477124183,5.44177449168207,FALSE,1,10
"Gary Grant",552,231,12602,1864,4140,95,342,1769,3798,545,702,347,936,1283,3013,821,69,1268,1200,4368,22.8297101449275,0.45024154589372,0.277777777777778,0.465771458662454,0.776353276353276,7.91304347826087,FALSE,1,13
"Gary Neal",458,35,9814,1656,3995,578,1547,1078,2448,671,781,105,874,979,756,186,11,494,678,4561,21.4279475982533,0.414518147684606,0.373626373626374,0.440359477124183,0.859154929577465,9.9585152838428,FALSE,1,7
"Gary Payton",1415,1313,50325,9373,20164,1186,3752,8187,16412,3515,4832,1471,4132,5603,9629,2578,305,3217,3398,23447,35.565371024735,0.464838325729022,0.316098081023454,0.498842310504509,0.727442052980132,16.5703180212014,TRUE,1,17
"Gilbert Arenas",622,471,21147,3991,9584,1176,3404,2815,6180,2999,3737,466,1891,2357,3183,958,155,1921,1871,12157,33.9983922829582,0.416423205342237,0.345475910693302,0.455501618122977,0.802515386673803,19.5450160771704,FALSE,1,11
"Greg Anthony",817,265,17364,2097,5225,658,1911,1439,3314,1119,1536,293,1256,1549,3279,964,84,1137,1438,5971,21.2533659730722,0.40133971291866,0.344322344322344,0.434218467109234,0.728515625,7.30844553243574,FALSE,1,11
"Greg Graham",260,23,3143,409,1006,81,251,328,755,279,361,76,200,276,253,153,13,225,277,1178,12.0884615384615,0.406560636182903,0.322709163346614,0.434437086092715,0.772853185595568,4.53076923076923,FALSE,1,5
"Greg Grant",373,7,4768,448,1144,56,198,392,946,123,168,85,266,351,1065,228,12,307,401,1075,12.7828418230563,0.391608391608392,0.282828282828283,0.414376321353066,0.732142857142857,2.88203753351206,FALSE,1,6
"Greg Sutton",216,10,2601,357,904,163,438,194,466,136,182,30,173,203,386,109,15,245,409,1013,12.0416666666667,0.394911504424779,0.372146118721461,0.416309012875536,0.747252747252747,4.68981481481481,FALSE,1,3
"Greivis Vásquez",480,180,11299,1655,3955,521,1469,1134,2486,518,626,145,1049,1194,2258,267,39,881,910,4349,23.5395833333333,0.418457648546144,0.354663036078965,0.456154465004023,0.827476038338658,9.06041666666667,FALSE,1,7
"Harold Miner",200,47,3748,692,1504,23,74,669,1430,394,502,191,241,432,245,80,27,278,370,1801,18.74,0.460106382978723,0.310810810810811,0.467832167832168,0.784860557768924,9.005,FALSE,1,4
"Haywoode Workman",395,161,7552,779,1876,133,411,646,1465,362,476,151,694,845,1471,374,21,556,721,2053,19.1189873417722,0.415245202558635,0.32360097323601,0.440955631399317,0.760504201680672,5.19746835443038,FALSE,1,8
"Hersey Hawkins",983,896,32034,4889,10612,1226,3108,3663,7504,3466,3985,825,2729,3554,2860,1622,302,1828,2043,14470,32.587995930824,0.460704862419902,0.394465894465894,0.488139658848614,0.869761606022585,14.7202441505595,FALSE,1,13
"Howard Eisley",934,194,18416,2121,5293,590,1716,1531,3577,965,1166,243,1291,1534,3185,625,96,1341,1953,5797,19.7173447537473,0.400717929340639,0.343822843822844,0.428012300810735,0.827615780445969,6.20663811563169,FALSE,1,12
"Hubert Davis",768,167,16913,2305,5044,806,1823,1499,3221,695,827,239,953,1192,1286,334,45,730,1144,6111,22.0221354166667,0.456978588421887,0.442128359846407,0.465383421297734,0.840386940749698,7.95703125,FALSE,1,12
"Isaiah Rider",563,424,17851,3583,8085,667,1896,2916,6189,1572,1935,676,1490,2166,1535,367,136,1425,1327,9405,31.7069271758437,0.443166357452072,0.351793248945148,0.471158507028599,0.812403100775194,16.7051509769094,FALSE,1,9
"Isiah Thomas",979,971,35516,7194,15904,398,1373,6796,14531,4036,5316,951,2527,3478,9061,1861,249,3682,2971,18822,36.2778345250255,0.452339034205231,0.289876183539694,0.467689766705664,0.759217456734387,19.2257405515832,TRUE,1,13
"J.R. Bremer",136,45,2389,257,780,139,434,118,346,111,151,36,181,217,266,74,11,107,144,764,17.5661764705882,0.32948717948718,0.320276497695853,0.341040462427746,0.735099337748344,5.61764705882353,FALSE,1,2
"Jacque Vaughn",776,123,12658,1300,3028,95,270,1205,2758,768,986,148,880,1028,1919,403,15,792,1267,3463,16.3118556701031,0.429326287978864,0.351851851851852,0.43691080493111,0.778904665314402,4.46262886597938,FALSE,1,12
"Jamaal Tinsley",547,404,14443,1759,4481,397,1326,1362,3155,737,1029,345,1260,1605,3330,776,155,1375,1306,4652,26.4040219378428,0.392546306627985,0.299396681749623,0.431695721077655,0.71622934888241,8.50457038391225,FALSE,1,11
"James Robinson",412,51,7441,1117,2847,421,1225,696,1622,410,615,217,505,722,771,227,79,548,708,3065,18.0606796116505,0.392342817000351,0.343673469387755,0.429099876695438,0.666666666666667,7.43932038834951,FALSE,1,7
"Jannero Pargo",562,19,8435,1387,3551,461,1302,926,2249,354,409,130,643,773,1123,281,37,648,740,3589,15.008896797153,0.390594198817235,0.354070660522273,0.411738550466874,0.865525672371638,6.38612099644128,FALSE,1,11
"Jared Cunningham",141,6,1095,102,299,32,108,70,191,107,157,10,90,100,67,38,4,55,129,343,7.76595744680851,0.341137123745819,0.296296296296296,0.366492146596859,0.681528662420382,2.43262411347518,FALSE,1,4
"Jaren Jackson",431,71,7210,865,2215,346,980,519,1235,294,385,207,579,786,500,258,53,348,725,2370,16.7285382830626,0.390519187358916,0.353061224489796,0.420242914979757,0.763636363636364,5.49883990719258,FALSE,1,12
"Jason Hart",421,80,6505,745,1793,71,238,674,1555,391,490,103,610,713,931,311,40,338,654,1952,15.4513064133017,0.415504740658115,0.298319327731092,0.433440514469453,0.797959183673469,4.63657957244656,FALSE,1,9
"Jason Kidd",1526,1475,54981,6737,16879,2168,6178,4569,10701,3350,4284,1926,7648,9574,13393,2944,496,4411,2851,18992,36.0294888597641,0.399135019847147,0.350922628682422,0.426969442108214,0.781979458450047,12.4456094364351,TRUE,1,19
"Jason Williams",815,667,23483,3087,7766,1248,3822,1839,3944,898,1104,195,1645,1840,4663,944,61,1661,1108,8320,28.8134969325153,0.397501931496266,0.326530612244898,0.466277890466531,0.813405797101449,10.2085889570552,FALSE,1,12
"Javaris Crittenton",226,20,3706,458,1036,24,104,434,932,250,392,168,384,552,402,118,16,274,296,1190,16.3982300884956,0.442084942084942,0.230769230769231,0.465665236051502,0.637755102040816,5.26548672566372,FALSE,1,2
"Jay Humphries",874,590,25072,3794,7934,224,760,3570,7174,1663,2138,582,1608,2190,4753,1243,94,1677,2385,9475,28.6864988558352,0.478195109654651,0.294736842105263,0.497630331753554,0.777829747427502,10.8409610983982,FALSE,1,11
"Jeff Hornacek",1157,972,36784,6401,12961,898,2263,5503,10698,3233,3686,979,2946,3925,5700,1663,239,2142,2550,16933,31.7925669835782,0.493866214026695,0.396818382677861,0.514395214058703,0.877102550189908,14.6352636127917,FALSE,1,14
"Jeff Malone",1014,831,32730,7700,15948,98,349,7602,15599,3181,3662,631,1972,2603,2305,633,105,1645,1843,18679,32.2781065088757,0.482819162277402,0.28080229226361,0.487338931982819,0.868651010376843,18.4211045364892,FALSE,1,13
"Jeff Martin",143,49,2685,384,921,29,103,355,818,159,229,131,159,290,109,78,47,96,201,956,18.7762237762238,0.416938110749186,0.281553398058252,0.43398533007335,0.694323144104803,6.68531468531468,FALSE,1,2
"Jeff McInnis",646,391,18292,2523,5828,351,1056,2172,4772,827,1039,276,1070,1346,2944,443,37,909,1357,6224,28.3157894736842,0.432910089224434,0.332386363636364,0.455155071248952,0.795957651588065,9.63467492260062,FALSE,1,11
"Jermaine Jackson",188,4,1903,129,332,4,29,125,303,121,169,53,149,202,258,61,15,112,178,383,10.1223404255319,0.38855421686747,0.137931034482759,0.412541254125413,0.715976331360947,2.03723404255319,FALSE,1,5
"Jerome Allen",193,2,2248,192,547,70,219,122,328,110,180,55,166,221,353,83,13,172,210,564,11.6476683937824,0.351005484460695,0.319634703196347,0.371951219512195,0.611111111111111,2.92227979274611,FALSE,1,2
"Jerry Eaves",168,8,2685,416,882,1,14,415,868,299,387,64,144,208,414,85,8,251,218,1132,15.9821428571429,0.471655328798186,0.0714285714285714,0.478110599078341,0.772609819121447,6.73809523809524,FALSE,1,4
"Jerry Sichting",685,NA,13922,1932,3828,61,211,1871,3617,550,646,208,664,872,2149,476,21,701,1040,4475,20.3240875912409,0.504702194357367,0.289099526066351,0.517279513408902,0.851393188854489,6.53284671532847,FALSE,1,10
"Jim Brogan",121,19,1493,256,577,12,45,244,532,95,127,94,88,182,222,75,22,126,202,619,12.3388429752066,0.44367417677643,0.266666666666667,0.458646616541353,0.748031496062992,5.11570247933884,FALSE,1,2
"Jim Farmer",163,2,1910,376,866,27,101,349,765,191,261,106,148,254,149,55,6,156,222,970,11.7177914110429,0.434180138568129,0.267326732673267,0.456209150326797,0.731800766283525,5.95092024539877,FALSE,1,5
"Jim Les",328,13,4314,377,952,196,496,181,456,283,347,89,314,403,951,172,20,305,430,1233,13.1524390243902,0.396008403361345,0.395161290322581,0.396929824561404,0.815561959654179,3.75914634146341,FALSE,1,7
"Jim Thomas",161,67,3361,541,1148,9,53,532,1095,264,346,136,282,418,377,142,12,210,322,1355,20.8757763975155,0.471254355400697,0.169811320754717,0.485844748858447,0.763005780346821,8.41614906832298,FALSE,1,4
"Joe Dumars",1018,944,35139,5994,13026,990,2592,5004,10434,3423,4059,671,1532,2203,4612,902,83,2084,1826,16401,34.5176817288802,0.460156609857209,0.381944444444444,0.479585968947671,0.843311160384331,16.1110019646365,TRUE,1,14
"John Bagley",665,401,17120,2359,5398,114,473,2245,4925,970,1245,413,1316,1729,3980,755,54,1512,1090,5802,25.7443609022556,0.43701370878103,0.241014799154334,0.455837563451777,0.779116465863454,8.72481203007519,FALSE,1,11
"John Battle",612,62,10910,2054,4430,62,227,1992,4203,1168,1472,178,646,824,1257,273,43,659,874,5338,17.8267973856209,0.463656884875846,0.273127753303965,0.473947180585296,0.793478260869565,8.72222222222222,FALSE,1,10
"John Crotty",504,6,6177,676,1573,158,411,518,1162,552,658,144,389,533,1062,192,20,461,628,2062,12.2559523809524,0.429752066115702,0.384428223844282,0.44578313253012,0.838905775075988,4.09126984126984,FALSE,1,11
"John Duren",201,NA,2947,317,729,3,25,314,704,75,100,60,166,226,411,104,11,205,400,712,14.6616915422886,0.434842249657064,0.12,0.446022727272727,0.75,3.54228855721393,FALSE,1,3
"John Lucas III",242,8,2927,454,1185,163,474,291,711,76,99,57,180,237,362,88,2,128,195,1147,12.095041322314,0.383122362869198,0.343881856540084,0.409282700421941,0.767676767676768,4.7396694214876,FALSE,1,8
"John Paxson",772,369,17257,2403,4812,273,769,2130,4043,481,598,167,739,906,2758,517,44,651,1430,5560,22.3536269430052,0.499376558603491,0.355006501950585,0.526836507543903,0.804347826086957,7.2020725388601,FALSE,1,11
"John Starks",903,450,24704,4156,10132,1281,3762,2875,6370,1751,2270,427,1803,2230,3266,993,110,1600,2395,11344,27.3576965669989,0.410185550730359,0.340510366826156,0.451334379905808,0.77136563876652,12.562569213732,FALSE,1,13
"John Stockton",1504,1300,47764,7039,13658,845,2203,6194,11455,4788,5796,966,3085,4051,15806,3265,315,4244,3942,19711,31.7579787234043,0.515375604041587,0.383567862006355,0.54072457442165,0.826086956521739,13.1057180851064,TRUE,1,19
"Johnny Dawkins",541,303,14859,2361,5175,180,545,2181,4630,1082,1262,333,1003,1336,2997,618,29,1108,837,5984,27.4658040665434,0.456231884057971,0.330275229357798,0.471058315334773,0.857369255150555,11.0609981515712,FALSE,1,9
"Johnny Moore",525,NA,13491,2002,4353,94,375,1908,3978,800,1123,393,1161,1554,3878,1020,116,1170,1326,4898,25.6971428571429,0.45991270388238,0.250666666666667,0.479638009049774,0.712377560106857,9.32952380952381,FALSE,1,9
"Jon Barry",890,38,15385,1756,4040,728,1841,1028,2199,930,1094,344,1328,1672,1951,782,120,875,1111,5170,17.2865168539326,0.434653465346535,0.395437262357414,0.467485220554798,0.850091407678245,5.80898876404494,FALSE,1,14
"Jon Sundvold",502,71,8811,1647,3642,226,576,1421,3066,366,431,132,422,554,1469,220,5,560,601,3886,17.5517928286853,0.452224052718287,0.392361111111111,0.463470319634703,0.849187935034803,7.7410358565737,FALSE,1,9
"Jonny Flynn",192,91,4154,597,1510,128,383,469,1127,313,390,52,294,346,730,128,9,418,202,1635,21.6354166666667,0.395364238410596,0.33420365535248,0.416149068322981,0.802564102564103,8.515625,FALSE,1,3
"Jordan Farmar",504,40,9840,1460,3452,583,1559,877,1893,385,521,161,797,958,1453,391,56,695,713,3888,19.5238095238095,0.422943221320973,0.373957665169981,0.463285789751717,0.738963531669866,7.71428571428571,FALSE,1,10
"Juan Dixon",570,83,11103,1805,4354,440,1270,1365,3084,669,799,197,852,1049,995,438,45,707,972,4719,19.4789473684211,0.414561322921452,0.346456692913386,0.442607003891051,0.83729662077597,8.27894736842105,FALSE,1,7
"Junior Harrington",140,66,3096,290,782,20,73,270,709,133,193,69,312,381,428,126,25,250,401,733,22.1142857142857,0.370843989769821,0.273972602739726,0.380818053596615,0.689119170984456,5.23571428571429,FALSE,1,3
"Kareem Rush",394,100,6924,1033,2595,339,942,694,1653,210,294,124,537,661,421,170,81,345,533,2615,17.5736040609137,0.398073217726397,0.359872611464968,0.419842710223835,0.714285714285714,6.63705583756345,FALSE,1,7
"Keith Edmonson",142,2,1553,364,781,0,2,364,779,204,279,112,103,215,90,63,20,142,207,932,10.9366197183099,0.46606914212548,0,0.467265725288832,0.731182795698925,6.56338028169014,FALSE,1,2
"Keith Jennings",164,26,2955,353,809,136,364,217,445,248,291,44,204,248,614,164,2,201,213,1090,18.0182926829268,0.436341161928307,0.373626373626374,0.487640449438202,0.852233676975945,6.64634146341463,FALSE,1,3
"Keith McLeod",248,97,4441,436,1206,75,254,361,952,389,478,44,267,311,626,169,32,296,410,1336,17.9072580645161,0.361525704809287,0.295275590551181,0.379201680672269,0.813807531380753,5.38709677419355,FALSE,1,4
"Kelvin Ransey",474,NA,11586,2207,4862,20,152,2187,4710,946,1209,227,674,901,2480,472,34,958,923,5380,24.4430379746835,0.45392842451666,0.131578947368421,0.464331210191083,0.782464846980976,11.3502109704641,FALSE,1,6
"Kelvin Upshaw",192,1,2522,430,947,21,89,409,858,147,190,58,177,235,428,134,13,203,343,1028,13.1354166666667,0.454065469904963,0.235955056179775,0.476689976689977,0.773684210526316,5.35416666666667,FALSE,1,3
"Kendall Marshall",160,57,3083,315,789,128,346,187,443,44,72,23,230,253,779,107,10,285,180,802,19.26875,0.399239543726236,0.369942196531792,0.422121896162528,0.611111111111111,5.0125,FALSE,1,4
"Kenny Anderson",1092,835,31948,4867,11603,703,2016,4164,9587,2723,3459,827,2410,3237,6417,1547,131,2182,2480,13160,29.2564102564103,0.419460484357494,0.348710317460317,0.43433816626682,0.787221740387395,12.0512820512821,FALSE,1,14
"Kenny Battle",206,25,2832,387,781,7,55,380,726,217,294,225,294,519,172,160,51,148,332,998,13.747572815534,0.495518565941101,0.127272727272727,0.523415977961432,0.738095238095238,4.84466019417476,FALSE,1,4
"Kenny Satterfield",114,16,1564,183,565,17,83,166,482,70,96,49,89,138,244,71,5,139,115,453,13.719298245614,0.323893805309734,0.204819277108434,0.344398340248963,0.729166666666667,3.97368421052632,FALSE,1,2
"Kenny Smith",864,704,25399,4006,8402,749,1883,3257,6519,1879,2267,303,1352,1655,4634,857,73,1889,1358,10640,29.3969907407407,0.476791240180909,0.397769516728625,0.499616505599018,0.828848698720776,12.3148148148148,FALSE,1,10
"Kerry Kittles",507,455,16929,2779,6337,694,1838,2085,4499,913,1171,513,1470,1983,1295,811,221,621,893,7165,33.3905325443787,0.438535584661512,0.377584330794342,0.46343631918204,0.779675491033305,14.1321499013807,FALSE,1,8
"Kevin Edwards",643,307,15819,2707,6424,182,540,2525,5884,1150,1430,536,1171,1707,1648,851,198,1168,1056,6746,24.601866251944,0.421388542963885,0.337037037037037,0.42912984364378,0.804195804195804,10.4914463452566,FALSE,1,11
"Kevin Johnson",815,651,26978,4787,9756,165,548,4622,9208,4120,4902,523,2072,2595,7148,1185,200,2404,1696,13859,33.1018404907975,0.490672406724067,0.301094890510949,0.501954821894005,0.84047327621379,17.0049079754601,FALSE,1,12
"Kevin Martin",815,560,24287,4292,9909,1260,3315,3032,6594,4012,4603,444,2108,2552,1521,715,87,1346,1540,13856,29.8,0.43314158845494,0.380090497737557,0.45981195025781,0.871605474690419,17.001226993865,FALSE,1,12
"Kevin McKenna",243,26,3460,498,1204,103,281,395,923,221,270,102,215,317,342,184,25,204,491,1320,14.238683127572,0.413621262458472,0.366548042704626,0.42795232936078,0.818518518518519,5.4320987654321,FALSE,1,6
"Kevin Ollie",938,126,15344,1298,3158,13,41,1285,3117,1235,1577,221,1304,1525,2297,512,34,766,1150,3844,16.3582089552239,0.411019632678911,0.317073170731707,0.412255373756817,0.783132530120482,4.09808102345416,FALSE,1,13
"Kevin Pritchard",113,1,1319,132,330,10,51,122,279,110,140,17,85,102,186,39,14,94,168,384,11.6725663716814,0.4,0.196078431372549,0.437275985663082,0.785714285714286,3.39823008849558,FALSE,1,4
"Kevin Williams",310,13,3494,576,1338,3,32,573,1306,322,402,187,239,426,372,197,45,306,671,1477,11.2709677419355,0.430493273542601,0.09375,0.43874425727412,0.800995024875622,4.76451612903226,FALSE,1,5
"Keyon Dooling",728,86,14134,1810,4356,446,1277,1364,3079,1001,1253,132,832,964,1601,463,75,803,1221,5067,19.4148351648352,0.415518824609734,0.349256068911511,0.443000974342319,0.798882681564246,6.96016483516483,FALSE,1,13
"Khalid Reeves",391,155,8102,1023,2485,346,965,677,1520,570,766,215,563,778,1230,305,44,617,903,2962,20.7212276214834,0.411670020120724,0.358549222797927,0.445394736842105,0.744125326370757,7.57544757033248,FALSE,1,6
"Kirk Hinrich",997,723,29803,3830,9274,1271,3372,2559,5902,1537,1912,339,2489,2828,4606,1062,262,1768,2736,10468,29.8926780341023,0.41298253180936,0.376927639383155,0.433581836665537,0.803870292887029,10.4994984954865,FALSE,1,13
"Kyle Macy",551,NA,14246,2175,4339,192,569,1983,3770,717,821,311,903,1214,2198,631,49,712,1081,5259,25.8548094373866,0.501267573173542,0.337434094903339,0.525994694960212,0.873325213154689,9.54446460980036,FALSE,1,7
"LaBradford Smith",249,42,4008,609,1428,52,164,557,1264,280,351,124,231,355,503,182,20,266,468,1550,16.0963855421687,0.426470588235294,0.317073170731707,0.440664556962025,0.797720797720798,6.22489959839357,FALSE,1,3
"Lancaster Gordon",201,6,2581,472,1208,23,85,449,1123,158,206,116,143,259,294,128,31,237,266,1125,12.8407960199005,0.390728476821192,0.270588235294118,0.399821905609973,0.766990291262136,5.59701492537313,FALSE,1,4
"Lance Blanks",142,2,1045,116,266,19,75,97,191,38,57,31,79,110,117,39,8,63,122,289,7.35915492957746,0.43609022556391,0.253333333333333,0.507853403141361,0.666666666666667,2.03521126760563,FALSE,1,3
"Larry Drew",714,NA,18370,3308,7085,118,405,3190,6680,1376,1724,259,1006,1265,3702,791,45,1565,1286,8110,25.7282913165266,0.466901905434016,0.291358024691358,0.477544910179641,0.798143851508121,11.3585434173669,FALSE,1,10
"Lawrence Moten",119,21,1814,286,701,59,197,227,504,116,178,80,101,181,182,77,32,126,143,747,15.2436974789916,0.407988587731812,0.299492385786802,0.450396825396825,0.651685393258427,6.27731092436975,FALSE,1,3
"Leandro Barbosa",914,112,19768,3674,8046,1053,2726,2621,5320,1342,1635,352,1496,1848,1871,749,128,1155,1786,9743,21.6280087527352,0.456624409644544,0.386280264123257,0.492669172932331,0.820795107033639,10.6597374179431,FALSE,1,14
"Ledell Eackles",441,88,8917,1810,4071,137,408,1673,3663,1026,1338,362,617,979,740,249,31,600,794,4783,20.2199546485261,0.44460820437239,0.33578431372549,0.456729456729457,0.766816143497758,10.8458049886621,FALSE,1,7
"Lee Mayberry",496,150,10337,950,2287,379,1006,571,1281,267,405,142,500,642,1767,352,43,591,865,2546,20.8407258064516,0.415391342369917,0.376739562624254,0.445745511319282,0.659259259259259,5.13306451612903,FALSE,1,7
"Leon Wood",394,28,6638,918,2303,266,771,652,1532,572,725,116,347,463,1223,187,5,379,409,2674,16.8477157360406,0.398610508033,0.345006485084306,0.425587467362924,0.788965517241379,6.78680203045685,FALSE,1,6
"Lester Conner",761,285,15978,1735,3825,22,114,1713,3711,1105,1472,654,1319,1973,2834,1170,66,972,1111,4597,20.9960578186597,0.45359477124183,0.192982456140351,0.46160064672595,0.750679347826087,6.0407358738502,FALSE,1,12
"Lewis Lloyd",409,260,9529,2202,4197,10,47,2192,4150,785,1022,496,714,1210,1149,368,133,840,845,5199,23.2982885085575,0.524660471765547,0.212765957446809,0.528192771084337,0.768101761252446,12.7114914425428,FALSE,1,7
"Lindsey Hunter",937,438,23253,2970,7663,1075,2984,1895,4679,941,1261,438,1583,2021,2506,1120,165,1159,1857,7956,24.8164354322305,0.387576667101657,0.360254691689008,0.405001068604403,0.746233148295004,8.49092849519744,FALSE,1,17
"Litterial Green",148,4,1189,144,343,2,26,142,317,133,200,24,51,75,182,49,6,78,124,423,8.03378378378378,0.419825072886297,0.0769230769230769,0.44794952681388,0.665,2.85810810810811,FALSE,1,5
"Lloyd Daniels",252,43,4463,669,1701,199,651,470,1050,180,239,231,315,546,378,134,74,256,379,1717,17.7103174603175,0.393298059964727,0.30568356374808,0.447619047619048,0.753138075313807,6.81349206349206,FALSE,1,5
"Lorenzo Romar",368,NA,6261,884,1920,23,126,861,1794,344,462,87,391,478,1227,303,37,418,477,2135,17.0135869565217,0.460416666666667,0.182539682539683,0.479933110367893,0.744588744588745,5.80163043478261,FALSE,1,5
"Lowes Moore",112,NA,2118,312,706,11,55,301,651,117,156,59,168,227,316,89,19,159,266,752,18.9107142857143,0.441926345609065,0.2,0.462365591397849,0.75,6.71428571428571,FALSE,1,3
"Lucious Harris",800,145,15701,2194,5151,402,1155,1792,3996,994,1258,554,1310,1864,1130,556,86,594,1013,5784,19.62625,0.425936711318191,0.348051948051948,0.448448448448448,0.790143084260731,7.23,FALSE,1,12
"Luke Ridnour",891,507,22764,3059,7130,621,1782,2438,5348,1307,1522,386,1588,1974,3889,846,169,1415,1871,8046,25.5488215488216,0.429032258064516,0.348484848484849,0.455871353777113,0.858738501971091,9.03030303030303,FALSE,1,12
"Luther Head",380,86,8295,1080,2570,471,1216,609,1354,360,465,116,781,897,805,271,45,462,547,2991,21.828947368421,0.420233463035019,0.38733552631579,0.449778434268833,0.774193548387097,7.87105263157895,FALSE,1,6
"Mahmoud Abdul-Rauf",586,336,15628,3514,7943,474,1339,3040,6604,1051,1161,219,868,1087,2079,487,46,963,1106,8553,26.6689419795222,0.442402115069873,0.353995519044063,0.460327074500303,0.905254091300603,14.5955631399317,FALSE,1,9
"Marcus Banks",464,69,7843,1067,2431,190,566,877,1865,610,791,128,589,717,1037,345,83,606,927,2934,16.9030172413793,0.438914027149321,0.335689045936396,0.470241286863271,0.771175726927939,6.32327586206897,FALSE,1,8
"Marcus Thornton",737,193,16645,3082,7336,1077,3020,2005,4316,1115,1355,586,1454,2040,1010,601,92,729,1087,8356,22.584803256445,0.420119956379498,0.356622516556291,0.464550509731233,0.822878228782288,11.3378561736771,FALSE,1,8
"Mario West",162,9,796,56,125,2,10,54,115,40,71,60,82,142,51,45,8,31,134,154,4.91358024691358,0.448,0.2,0.469565217391304,0.563380281690141,0.950617283950617,FALSE,1,4
"Mark Jackson",1461,1256,44763,5326,11993,870,2598,4456,9395,2410,3124,1435,4228,5663,11930,1789,136,3604,2530,13932,30.6386036960986,0.444092387225882,0.334872979214781,0.474294837679617,0.771446862996159,9.53593429158111,FALSE,1,17
"Mark Macon",293,105,5514,763,1990,36,136,727,1854,286,392,191,317,508,479,388,21,363,660,1848,18.8191126279863,0.383417085427136,0.264705882352941,0.392125134843581,0.729591836734694,6.30716723549488,FALSE,1,6
"Mark Price",722,578,21560,3939,8345,976,2428,2963,5917,2135,2362,409,1439,1848,4863,860,76,1790,964,10989,29.8614958448753,0.472019173157579,0.401976935749588,0.500760520534054,0.9038950042337,15.2202216066482,FALSE,1,12
"Mateen Cleaves",167,10,1863,233,599,12,45,221,554,131,180,33,142,175,310,67,5,201,213,609,11.1556886227545,0.3889816360601,0.266666666666667,0.398916967509025,0.727777777777778,3.64670658682635,FALSE,1,6
"Matt Carroll",530,94,8276,1102,2683,358,952,744,1731,634,755,155,783,938,342,245,66,336,779,3196,15.6150943396226,0.410734252702199,0.376050420168067,0.429809358752166,0.839735099337748,6.03018867924528,FALSE,1,10
"Matt Maloney",295,206,7470,783,1920,399,1073,384,847,212,266,62,438,500,852,240,14,381,376,2177,25.3220338983051,0.4078125,0.371854613233924,0.453364817001181,0.796992481203007,7.37966101694915,FALSE,1,6
"Maurice Ager",108,7,670,85,254,14,63,71,191,36,65,12,47,59,27,6,7,35,82,220,6.2037037037037,0.334645669291339,0.222222222222222,0.3717277486911,0.553846153846154,2.03703703703704,FALSE,1,4
"Michael Adams",653,510,20446,3257,7849,949,2857,2308,4992,2158,2543,416,1484,1900,4209,1081,67,1402,1193,9621,31.3108728943338,0.414957319403746,0.332166608330417,0.462339743589744,0.848604011010617,14.7335375191424,FALSE,1,11
"Michael Dickerson",212,206,7490,1219,2824,288,717,931,2107,531,677,178,431,609,553,213,85,407,551,3257,35.3301886792453,0.431657223796034,0.401673640167364,0.441860465116279,0.784342688330872,15.3632075471698,FALSE,1,5
"Michael Holton",353,122,6348,873,1980,29,121,844,1859,424,535,142,350,492,1032,233,30,436,624,2199,17.9830028328612,0.440909090909091,0.239669421487603,0.454007530930608,0.792523364485981,6.22946175637394,FALSE,1,6
"Michael Phelps",132,24,1372,195,469,2,22,193,447,78,122,45,96,141,138,71,3,96,147,470,10.3939393939394,0.415778251599147,0.0909090909090909,0.431767337807606,0.639344262295082,3.56060606060606,FALSE,1,3
"Micheal Williams",441,265,10732,1530,3289,48,214,1482,3075,1581,1826,312,770,1082,2466,739,96,971,1112,4689,24.3356009070295,0.465186986926117,0.224299065420561,0.481951219512195,0.865826944140197,10.6326530612245,FALSE,1,10
"Mike Bibby",1129,1062,37820,5906,13591,1763,4595,4143,8996,2478,3105,562,2896,3458,6072,1276,162,2354,2203,16053,33.4986713906112,0.434552277242293,0.383677910772579,0.460538016896398,0.798067632850242,14.2187776793623,FALSE,1,14
"Mike Iuzzolino",122,44,3049,381,833,113,280,268,553,221,277,58,180,238,522,82,7,221,180,1096,24.9918032786885,0.457382953181273,0.403571428571429,0.484629294755877,0.79783393501805,8.98360655737705,FALSE,1,2
"Mike Wilks",341,18,3464,313,814,50,168,263,646,189,258,91,266,357,409,132,15,178,331,865,10.158357771261,0.384520884520885,0.297619047619048,0.407120743034056,0.732558139534884,2.5366568914956,FALSE,1,7
"Mike Woodson",884,NA,22523,4932,10510,128,475,4804,10035,2357,2914,760,1338,2098,2059,1099,315,1496,2085,12349,25.4785067873303,0.469267364414843,0.269473684210526,0.478724464374689,0.80885380919698,13.9694570135747,FALSE,1,11
"Milt Palacio",539,89,9211,945,2274,53,211,892,2063,531,737,170,734,904,1277,332,62,636,746,2474,17.0890538033395,0.4155672823219,0.251184834123223,0.432380029083858,0.720488466757124,4.5899814471243,FALSE,1,7
"Mitch Richmond",976,902,34309,7305,16038,1326,3417,5979,12621,4561,5365,881,2920,3801,3398,1211,254,2579,2503,20497,35.1526639344262,0.455480733258511,0.388059701492537,0.473734252436415,0.850139794967381,21.0010245901639,TRUE,1,14
"Mitchell Butler",362,33,5464,707,1613,95,313,612,1300,359,576,246,471,717,342,214,53,353,576,1868,15.0939226519337,0.438313701177929,0.303514376996805,0.470769230769231,0.623263888888889,5.16022099447514,FALSE,1,8
"Mitchell Wiggins",389,135,8105,1596,3468,14,73,1582,3395,671,889,585,650,1235,609,397,34,453,942,3877,20.8354755784062,0.460207612456747,0.191780821917808,0.465979381443299,0.754780652418448,9.96658097686375,FALSE,1,6
"Mo Williams",944,614,27640,4683,10916,1292,3483,3391,7433,1877,2159,450,2141,2591,4794,820,145,2192,2317,12535,29.2796610169492,0.429003297911323,0.370944587998852,0.456208798600834,0.869383974062066,13.2786016949153,FALSE,1,13
"Monta Ellis",891,771,31131,6173,13728,799,2550,5374,11178,2894,3738,540,2534,3074,4202,1494,299,2423,2086,16039,34.9393939393939,0.449664918414918,0.313333333333333,0.480765789944534,0.774210807918673,18.0011223344557,FALSE,1,12
"Moochie Norris",594,35,9271,977,2471,140,490,837,1981,627,845,241,792,1033,1443,403,27,648,628,2721,15.6077441077441,0.39538648320518,0.285714285714286,0.422513881877839,0.742011834319527,4.58080808080808,FALSE,1,9
"Mookie Blaylock",889,800,31026,4705,11499,1283,3816,3422,7683,1269,1724,1017,2642,3659,5972,2075,300,2067,1687,11962,34.8998875140607,0.409166014436038,0.336215932914046,0.445398932708577,0.736078886310905,13.4555680539933,FALSE,1,13
"Morlon Wiley",465,75,6290,659,1616,231,652,428,964,154,221,148,418,566,1181,392,25,491,725,1703,13.5268817204301,0.40779702970297,0.354294478527607,0.443983402489627,0.69683257918552,3.66236559139785,FALSE,1,7
"Muggsy Bogues",950,587,26999,2986,6533,110,397,2876,6136,1123,1352,564,1886,2450,7057,1436,42,1538,1640,7205,28.42,0.457064135925302,0.277078085642317,0.46870925684485,0.830621301775148,7.58421052631579,FALSE,1,14
"Nate McMillan",796,373,20462,1833,4136,298,870,1535,3266,769,1183,919,2303,3222,4893,1544,356,1486,2408,4733,25.7060301507538,0.443181818181818,0.342528735632184,0.469993876301286,0.650042265426881,5.94597989949749,FALSE,1,12
"Nate Robinson",775,121,16597,2911,6935,994,2790,1917,4145,1197,1514,445,1251,1696,2197,641,54,1047,1789,8013,21.4154838709677,0.419754866618601,0.356272401433692,0.46248492159228,0.790620871862616,10.3393548387097,FALSE,1,11
"Negele Knight",388,112,6659,981,2228,40,144,941,2084,491,654,163,352,515,1104,178,46,500,594,2493,17.1623711340206,0.440305206463196,0.277777777777778,0.451535508637236,0.750764525993884,6.42525773195876,FALSE,1,6
"Nick Calathes",129,7,2011,246,558,30,104,216,454,68,117,42,201,243,353,129,13,162,217,590,15.5891472868217,0.440860215053763,0.288461538461538,0.475770925110132,0.581196581196581,4.57364341085271,FALSE,1,2
"Nick Van Exel",952,716,31465,5137,12684,1647,4628,3490,8056,2059,2592,403,2396,2799,6255,770,103,2006,1484,13980,33.0514705882353,0.404998423210344,0.355877268798617,0.433217477656405,0.794367283950617,14.6848739495798,FALSE,1,13
"Norris Cole",435,85,9849,1235,3027,262,815,973,2212,347,470,92,769,861,1236,337,49,616,803,3079,22.6413793103448,0.40799471423852,0.321472392638037,0.439873417721519,0.738297872340426,7.07816091954023,FALSE,1,6
"O.J. Mayo",547,325,16919,2808,6547,854,2287,1954,4260,1104,1346,285,1421,1706,1607,559,141,1130,1239,7574,30.9305301645338,0.428898732243776,0.373414954088325,0.45868544600939,0.820208023774146,13.8464351005484,FALSE,1,8
"Orien Greene",131,7,1555,127,328,11,52,116,276,61,95,49,146,195,155,98,15,144,228,326,11.8702290076336,0.38719512195122,0.211538461538462,0.420289855072464,0.642105263157895,2.48854961832061,FALSE,1,4
"Orlando Johnson",155,2,1605,162,474,58,208,104,266,73,100,46,204,250,91,29,19,67,121,455,10.3548387096774,0.341772151898734,0.278846153846154,0.390977443609023,0.73,2.93548387096774,FALSE,1,3
"Othell Wilson",127,25,2049,216,476,6,34,210,442,97,130,63,149,212,424,119,16,172,189,535,16.1338582677165,0.453781512605042,0.176470588235294,0.475113122171946,0.746153846153846,4.21259842519685,FALSE,1,2
"Pablo Prigioni",337,54,5763,425,1014,260,701,165,313,110,127,175,449,624,936,347,7,319,517,1220,17.1008902077151,0.419132149901381,0.370898716119829,0.527156549520767,0.866141732283465,3.62017804154303,FALSE,1,4
"Paul Graham",179,20,3354,582,1299,100,295,482,1004,235,318,137,296,433,352,186,32,216,389,1499,18.7374301675978,0.448036951501155,0.338983050847458,0.4800796812749,0.738993710691824,8.37430167597765,FALSE,1,3
"Pearl Washington",194,79,4044,666,1472,16,87,650,1385,312,418,140,230,370,733,256,15,438,448,1660,20.8453608247423,0.452445652173913,0.183908045977011,0.469314079422383,0.746411483253589,8.55670103092783,FALSE,1,3
"Perry Moss",208,0,2722,323,791,15,78,308,713,179,247,97,228,325,306,154,33,215,360,840,13.0865384615385,0.40834386852086,0.192307692307692,0.431977559607293,0.724696356275304,4.03846153846154,FALSE,1,2
"Pete Myers",533,104,8152,871,2113,46,213,825,1900,631,947,303,637,940,1135,352,106,645,966,2419,15.2945590994371,0.412210127780407,0.215962441314554,0.43421052631579,0.666314677930306,4.53846153846154,FALSE,1,9
"Phil Pressey",171,11,2298,202,583,52,207,150,376,88,144,39,208,247,508,134,19,194,207,544,13.4385964912281,0.346483704974271,0.251207729468599,0.398936170212766,0.611111111111111,3.1812865497076,FALSE,1,3
"Pooh Richardson",639,483,19399,3046,6867,358,1087,2688,5780,633,971,435,1372,1807,4180,817,111,1165,1129,7083,30.358372456964,0.443570700451434,0.329346826126955,0.465051903114187,0.651905252317199,11.0845070422535,FALSE,1,10
"Quincy Douby",170,0,1835,264,681,82,264,182,417,93,105,40,144,184,118,55,26,100,155,703,10.7941176470588,0.387665198237885,0.310606060606061,0.436450839328537,0.885714285714286,4.13529411764706,FALSE,1,3
"Quintin Dailey",528,140,12170,2936,6460,21,133,2915,6327,1577,2025,421,886,1307,1188,500,51,1025,1231,7470,23.0492424242424,0.454489164086687,0.157894736842105,0.460723881776513,0.778765432098765,14.1477272727273,FALSE,1,10
"Rafer Alston",800,566,23260,2921,7657,1166,3314,1755,4343,1118,1527,293,1954,2247,3784,971,125,1430,1646,8126,29.075,0.381480997779809,0.351840675920338,0.404098549389823,0.73215455140799,10.1575,FALSE,1,11
"Raja Bell",779,550,22308,2908,6694,1082,2655,1826,4039,970,1206,454,1780,2234,1363,538,140,786,2021,7868,28.6367137355584,0.434418882581416,0.407532956685499,0.452092102005447,0.804311774461028,10.1001283697048,FALSE,1,12
"Randy Brown",655,169,11533,1275,3055,24,120,1251,2935,574,831,326,847,1173,1420,722,156,725,1263,3148,17.6076335877863,0.417348608837971,0.2,0.426235093696763,0.690734055354994,4.80610687022901,FALSE,1,12
"Randy Foye",833,441,20921,2873,7232,1179,3267,1694,3965,1278,1503,269,1573,1842,2273,567,249,1192,1715,8203,25.1152460984394,0.397262168141593,0.360881542699725,0.427238335435057,0.850299401197605,9.84753901560624,FALSE,1,11
"Randy Livingston",203,19,2684,304,749,34,97,270,652,131,170,74,208,282,415,121,31,223,297,773,13.2216748768473,0.405874499332443,0.350515463917526,0.414110429447853,0.770588235294118,3.80788177339901,FALSE,1,11
"Randy Woods",151,4,1093,115,338,57,187,58,151,69,101,32,61,93,257,85,4,110,166,356,7.23841059602649,0.340236686390533,0.304812834224599,0.384105960264901,0.683168316831683,2.35761589403974,FALSE,1,4
"Rashad McCants",307,42,6138,1115,2632,355,982,760,1650,448,601,135,481,616,399,230,75,426,687,3033,19.9934853420195,0.423632218844985,0.361507128309572,0.460606060606061,0.745424292845258,9.87947882736156,FALSE,1,4
"Raül López",113,26,2135,280,652,45,130,235,522,128,150,31,163,194,428,84,5,221,278,733,18.8938053097345,0.429447852760736,0.346153846153846,0.450191570881226,0.853333333333333,6.48672566371681,FALSE,1,2
"Ray Allen",1376,1224,49224,9165,20318,3174,7962,5991,12356,4714,5265,1324,4329,5653,4695,1554,258,2907,3078,26218,35.7732558139535,0.451077861994291,0.398643556895252,0.484865652314665,0.895346628679962,19.0537790697674,TRUE,1,18
"Ray McCallum",195,52,3283,429,1062,86,254,343,808,113,157,86,267,353,428,91,34,172,219,1057,16.8358974358974,0.403954802259887,0.338582677165354,0.42450495049505,0.719745222929936,5.42051282051282,FALSE,1,3
"Reggie Carter",135,NA,1459,178,459,0,3,178,456,115,149,65,99,164,206,58,8,116,192,471,10.8074074074074,0.387799564270152,0,0.390350877192982,0.771812080536913,3.48888888888889,FALSE,1,2
"Reggie Geary",101,2,931,78,227,20,61,58,166,33,67,23,59,82,110,50,14,57,131,209,9.21782178217822,0.343612334801762,0.327868852459016,0.349397590361446,0.492537313432836,2.06930693069307,FALSE,1,2
"Reggie Jordan",205,2,1792,198,446,2,6,196,440,142,246,191,179,370,202,99,34,112,216,540,8.74146341463415,0.443946188340807,0.333333333333333,0.445454545454545,0.577235772357724,2.63414634146341,FALSE,1,6
"Reggie Miller",1389,1304,47619,8241,17499,2560,6486,5681,11013,6237,7026,883,3299,4182,4141,1505,299,2409,2730,25279,34.2829373650108,0.470941196639808,0.394696268886833,0.515844910560247,0.887702818104184,18.1994240460763,TRUE,1,18
"Rex Chapman",688,501,20109,3829,8890,813,2330,3016,6560,1530,1921,389,1314,1703,1887,607,137,1075,1279,10001,29.2281976744186,0.430708661417323,0.348927038626609,0.459756097560976,0.79646017699115,14.5363372093023,FALSE,1,12
"Rex Walters",417,75,5447,657,1497,215,606,442,891,284,347,99,383,482,710,162,35,359,520,1813,13.0623501199041,0.438877755511022,0.354785478547855,0.496071829405163,0.818443804034582,4.34772182254197,FALSE,1,7
"Rick Brunson",426,51,5399,476,1263,118,326,358,937,238,341,100,427,527,1024,242,26,428,449,1308,12.6737089201878,0.376880443388757,0.361963190184049,0.382070437566702,0.697947214076246,3.07042253521127,FALSE,1,9
"Rick Carlisle",188,1,1461,178,422,11,48,167,374,55,71,44,97,141,201,42,9,120,187,422,7.77127659574468,0.421800947867299,0.229166666666667,0.446524064171123,0.774647887323944,2.24468085106383,FALSE,1,5
"Ricky Pierce",1107,298,27082,6191,12578,384,1131,5807,11447,3958,4497,967,1641,2608,2074,856,169,1668,2480,16724,24.4643179765131,0.492208618222293,0.339522546419098,0.507294487638683,0.880142317100289,15.1074977416441,FALSE,1,16
"Rob Williams",153,99,3367,500,1139,17,62,483,1077,302,383,91,239,330,825,173,17,354,489,1319,22.0065359477124,0.438981562774363,0.274193548387097,0.448467966573816,0.788511749347259,8.62091503267974,FALSE,1,2
"Robert Pack",606,199,13244,2011,4783,145,502,1866,4281,1525,1932,289,969,1258,3008,699,49,1537,1180,5692,21.8547854785479,0.420447417938532,0.288844621513944,0.435879467414156,0.789337474120083,9.39273927392739,FALSE,1,13
"Rod Foster",207,35,3446,631,1434,72,242,559,1192,228,297,75,183,258,479,137,10,286,441,1562,16.6473429951691,0.440027894002789,0.297520661157025,0.468959731543624,0.767676767676768,7.54589371980676,FALSE,1,3
"Rod Strickland",1291,802,38342,6093,13466,217,774,5876,12692,3808,5308,1332,3306,4638,9002,1831,245,3224,2360,16211,29.6994577846631,0.452472894697757,0.280361757105943,0.462968799243618,0.717407686510927,12.5569326103796,FALSE,1,17
"Rodney Stuckey",651,302,17890,2904,6870,276,921,2628,5949,2101,2551,419,1493,1912,2333,568,94,1181,1346,8185,27.4807987711214,0.422707423580786,0.299674267100977,0.441754916792738,0.82359858878871,12.5729646697389,FALSE,1,10
"Rodrigue Beaubois",182,54,2896,502,1143,129,397,373,746,153,189,47,291,338,374,124,52,204,312,1286,15.9120879120879,0.439195100612423,0.324937027707809,0.5,0.80952380952381,7.06593406593407,FALSE,1,4
"Rolando Blackman",980,815,32087,6887,13969,229,667,6658,13302,3620,4309,1047,2231,3278,2981,715,274,1829,1634,17623,32.7418367346939,0.49302025914525,0.343328335832084,0.500526236656142,0.8401021118589,17.9826530612245,FALSE,1,13
"Ron Harper",1044,1002,32566,5627,12583,537,1862,5090,10721,2917,4030,1396,3119,4515,4098,1797,770,2351,2429,14708,31.1934865900383,0.447190654057061,0.288399570354458,0.474769144669341,0.723821339950372,14.088122605364,FALSE,1,15
"Ronald Murray",694,140,15798,2560,6209,454,1509,2106,4700,1263,1752,276,1153,1429,1577,560,131,1060,1104,6837,22.7636887608069,0.412304718956354,0.300861497680583,0.448085106382979,0.720890410958904,9.85158501440922,FALSE,1,8
"Ronnie Lester",250,NA,4959,679,1449,5,22,674,1427,453,575,148,325,473,1003,187,32,474,395,1816,19.836,0.468599033816425,0.227272727272727,0.472319551506657,0.787826086956522,7.264,FALSE,1,6
"Ronnie Price",544,73,7293,738,1980,244,808,494,1172,295,400,176,482,658,960,424,56,476,922,2015,13.40625,0.372727272727273,0.301980198019802,0.421501706484642,0.7375,3.70404411764706,FALSE,1,12
"Rory Sparrow",1021,NA,26511,3831,8262,111,439,3720,7823,1107,1409,520,1565,2085,4839,988,116,1822,2306,8880,25.9657198824682,0.463689179375454,0.252847380410023,0.47552089991052,0.785663591199432,8.6973555337904,FALSE,1,12
"Royal Ivey",536,114,6488,657,1614,176,484,481,1130,244,345,153,438,591,528,249,40,266,796,1734,12.1044776119403,0.407063197026022,0.363636363636364,0.425663716814159,0.707246376811594,3.23507462686567,FALSE,1,10
"Rudy Fernández",249,10,5965,740,1853,413,1147,327,706,361,430,128,480,608,554,249,40,286,369,2254,23.9558232931727,0.399352401511063,0.360069747166521,0.463172804532578,0.83953488372093,9.05220883534137,FALSE,1,4
"Rumeal Robinson",421,128,7002,1135,2661,138,402,997,2259,445,729,176,509,685,1315,343,59,666,707,2853,16.6318289786223,0.426531379180759,0.343283582089552,0.441345728198318,0.61042524005487,6.77672209026128,FALSE,1,6
"Salim Stoudamire",157,1,2672,446,1097,167,456,279,641,201,228,22,192,214,164,55,10,158,240,1260,17.0191082802548,0.406563354603464,0.366228070175439,0.435257410296412,0.881578947368421,8.02547770700637,FALSE,1,3
"Sam Cassell",1117,771,32999,6307,13966,778,2346,5529,11620,3953,4589,687,2867,3554,6494,1181,188,2703,3064,17345,29.5425246195166,0.451596734927681,0.331628303495311,0.475817555938038,0.861407714098932,15.5282005371531,FALSE,1,15
"Sam Jacobson",120,10,1433,228,447,18,49,210,398,64,87,53,98,151,68,63,6,67,247,538,11.9416666666667,0.51006711409396,0.36734693877551,0.527638190954774,0.735632183908046,4.48333333333333,FALSE,1,3
"Sam Vincent",468,195,9028,1373,3052,24,109,1349,2943,909,1052,193,778,971,1924,323,76,791,743,3679,19.2905982905983,0.449868938401048,0.220183486238532,0.45837580699966,0.864068441064639,7.86111111111111,FALSE,1,7
"Šarūnas Jasikevičius",201,21,3503,426,1073,174,496,252,577,293,323,49,242,291,571,92,6,296,258,1319,17.4278606965174,0.397017707362535,0.350806451612903,0.436741767764298,0.907120743034056,6.56218905472637,FALSE,1,2
"Sasha Danilović",131,102,4120,579,1324,204,550,375,774,297,374,70,248,318,251,123,21,269,369,1659,31.4503816793893,0.437311178247734,0.370909090909091,0.484496124031008,0.794117647058823,12.6641221374046,FALSE,1,2
"Sasha Vujačić",648,75,10556,1314,3352,630,1713,684,1639,492,575,235,1044,1279,880,390,39,394,1016,3750,16.2901234567901,0.39200477326969,0.367775831873905,0.417327638804149,0.855652173913043,5.78703703703704,FALSE,1,10
"Scott Brooks",739,7,10045,1359,3013,312,840,1047,2173,628,743,172,579,751,1724,514,34,498,884,3658,13.5926928281461,0.451045469631596,0.371428571428571,0.481822365393465,0.845222072678331,4.94993234100135,FALSE,1,10
"Scott Skiles",600,371,16789,2290,5259,524,1381,1766,3878,1548,1741,275,1251,1526,3881,500,29,1497,1343,6652,27.9816666666667,0.435444000760601,0.379435191889935,0.455389375966993,0.889144170017231,11.0866666666667,FALSE,1,10
"Sean Green",120,0,1005,216,579,25,102,191,477,44,68,46,73,119,61,51,19,90,84,501,8.375,0.373056994818653,0.245098039215686,0.40041928721174,0.647058823529412,4.175,FALSE,1,3
"Sebastian Telfair",666,196,13788,1737,4463,427,1339,1310,3124,821,1056,169,858,1027,2239,474,91,973,1371,4722,20.7027027027027,0.389200089625812,0.318894697535474,0.419334186939821,0.777462121212121,7.09009009009009,FALSE,1,10
"Sedale Threatt",1090,312,24937,4369,9034,198,701,4171,8333,1463,1798,420,1485,1905,4032,1272,157,1448,2442,10399,22.8779816513761,0.483617445206996,0.282453637660485,0.500540021600864,0.813681868743048,9.54036697247706,FALSE,1,14
"Sedric Toney",189,18,2608,254,697,57,164,197,533,188,242,39,144,183,435,87,1,209,289,753,13.7989417989418,0.36441893830703,0.347560975609756,0.369606003752345,0.776859504132231,3.98412698412698,FALSE,1,5
"Sergio Rodríguez",419,60,6329,843,2002,234,691,609,1311,261,354,145,469,614,1395,262,18,605,525,2181,15.1050119331742,0.421078921078921,0.338639652677279,0.464530892448513,0.73728813559322,5.20525059665871,FALSE,1,5
"Shammond Williams",456,43,7995,991,2495,379,1061,612,1434,413,516,139,610,749,1147,310,22,492,581,2774,17.5328947368421,0.397194388777555,0.357210179076343,0.426778242677824,0.800387596899225,6.08333333333333,FALSE,1,7
"Shannon Brown",506,65,8297,1344,3211,299,900,1045,2311,510,642,201,651,852,522,330,100,458,633,3497,16.397233201581,0.418561195889131,0.332222222222222,0.452185201211597,0.794392523364486,6.91106719367589,FALSE,1,9
"Shawn Respert",270,9,3756,504,1192,148,435,356,757,206,252,132,233,365,278,145,10,203,307,1362,13.9111111111111,0.422818791946309,0.340229885057471,0.470277410832233,0.817460317460317,5.04444444444444,FALSE,1,4
"Sherman Douglas",886,550,24235,3797,7824,195,696,3602,7128,1834,2687,626,1289,1915,5144,873,90,2023,1856,9623,27.3532731376975,0.48530163599182,0.280172413793103,0.505331088664422,0.682545589877186,10.8611738148984,FALSE,1,12
"Sidney Lowe",214,40,3612,208,567,4,31,204,536,170,220,85,266,351,799,202,9,204,310,590,16.8785046728972,0.3668430335097,0.129032258064516,0.380597014925373,0.772727272727273,2.75700934579439,FALSE,1,4
"Sleepy Floyd",1110,674,30145,5094,11511,542,1696,4552,9815,3297,4027,759,2168,2927,5857,1273,244,2580,2296,14027,27.1576576576577,0.442533229085223,0.319575471698113,0.463779928680591,0.818723615594735,12.6369369369369,FALSE,1,13
"Smush Parker",318,186,7805,990,2356,310,929,680,1427,392,555,127,595,722,890,365,50,559,682,2682,24.5440251572327,0.420203735144312,0.333692142088267,0.476524176594254,0.706306306306306,8.43396226415094,FALSE,1,5
"Speedy Claxton",396,175,10414,1383,3364,53,279,1330,3085,989,1307,231,783,1014,1815,612,48,699,1011,3808,26.2979797979798,0.411117717003567,0.189964157706093,0.431118314424635,0.756694720734506,9.61616161616162,FALSE,1,7
"Spud Webb",891,450,21750,3089,6851,367,1147,2722,5704,2071,2441,350,1492,1842,4636,974,118,1733,1747,8616,24.4107744107744,0.450883082761641,0.319965126416739,0.477208976157083,0.848422777550184,9.67003367003367,FALSE,1,12
"Stephon Marbury",976,946,37040,6745,15593,1144,3519,5601,12074,4346,5518,674,2247,2921,7627,1210,138,2960,2311,18980,37.9508196721311,0.432565894952863,0.325092355782893,0.463889349014411,0.787604204421892,19.4467213114754,FALSE,1,13
"Steve Alford",235,6,2547,439,958,55,163,384,795,177,207,35,181,216,268,130,13,134,170,1110,10.8382978723404,0.458246346555324,0.337423312883436,0.483018867924528,0.855072463768116,4.72340425531915,FALSE,1,4
"Steve Blake",1087,455,26705,2620,6529,1299,3421,1321,3108,615,801,305,2026,2331,4541,760,85,1581,1616,7154,24.5676172953082,0.401286567621382,0.37971353405437,0.425032175032175,0.767790262172285,6.58141674333027,FALSE,1,13
"Steve Burtt",101,2,1121,218,512,2,14,216,498,146,210,28,64,92,123,49,13,110,195,584,11.0990099009901,0.42578125,0.142857142857143,0.433734939759036,0.695238095238095,5.78217821782178,FALSE,1,4
"Steve Colter",664,254,12405,1667,3729,83,290,1584,3439,810,1041,378,954,1332,1953,581,102,692,1128,4227,18.6822289156627,0.447036739072137,0.286206896551724,0.460599011340506,0.778097982708934,6.36596385542169,FALSE,1,8
"Steve Francis",646,603,24025,3876,9032,600,1767,3276,7265,3099,3893,1034,2471,3505,3818,920,240,2244,2017,11451,37.1904024767802,0.429140832595217,0.33955857385399,0.450929112181693,0.796044181864886,17.7260061919505,FALSE,1,9
"Steve Harris",265,55,3924,815,1850,1,27,814,1823,344,416,207,284,491,325,166,37,225,354,1975,14.8075471698113,0.440540540540541,0.037037037037037,0.446516730663741,0.826923076923077,7.45283018867925,FALSE,1,5
"Steve Henson",238,3,2282,254,631,105,243,149,388,126,145,46,130,176,465,88,2,175,283,739,9.58823529411765,0.402535657686212,0.432098765432099,0.384020618556701,0.868965517241379,3.10504201680672,FALSE,1,7
"Steve Kerr",962,30,16688,2095,4385,732,1625,1363,2760,649,750,191,914,1105,1728,486,47,531,883,5571,17.3471933471933,0.477765108323831,0.450461538461538,0.493840579710145,0.865333333333333,5.79106029106029,FALSE,1,15
"Steve Nash",1217,1053,38069,6321,12892,1685,3939,4636,8953,3060,3384,643,2999,3642,10335,899,102,3478,1982,17387,31.2810188989318,0.490304064536146,0.427773546585428,0.517815257455602,0.904255319148936,14.2867707477403,TRUE,1,18
"Steve Smith",1072,779,32270,5139,11738,1326,3729,3813,8009,3445,4076,1231,2170,3401,3267,802,315,1896,2585,15049,30.1026119402985,0.4378088260351,0.355591311343524,0.476089399425646,0.845191364082434,14.0382462686567,FALSE,1,14
"Sundiata Gaines",137,12,1612,224,563,53,184,171,379,118,214,59,154,213,249,99,4,120,125,619,11.7664233576642,0.397868561278863,0.28804347826087,0.451187335092348,0.551401869158878,4.51824817518248,FALSE,1,3
"T.J. Ford",429,306,11882,1829,4223,127,439,1702,3784,1012,1242,296,1035,1331,2495,496,55,1047,972,4797,27.6969696969697,0.43310442813166,0.289293849658314,0.449788583509514,0.814814814814815,11.1818181818182,FALSE,1,8
"Tarence Kinsey",109,15,1340,186,411,23,71,163,340,116,142,42,105,147,53,68,1,71,102,511,12.2935779816514,0.452554744525547,0.323943661971831,0.479411764705882,0.816901408450704,4.68807339449541,FALSE,1,3
"Tariq Abdul-Wahad",321,213,6826,1049,2519,22,101,1027,2418,542,755,428,723,1151,388,263,121,442,688,2662,21.2647975077882,0.416435093290988,0.217821782178218,0.424731182795699,0.717880794701987,8.29283489096573,FALSE,1,6
"Tate George",177,14,2019,297,717,1,14,296,703,141,172,65,115,180,325,76,11,157,182,736,11.406779661017,0.414225941422594,0.0714285714285714,0.421052631578947,0.819767441860465,4.15819209039548,FALSE,1,4
"Terence Stansbury",192,31,2984,468,1055,24,107,444,948,240,308,76,201,277,390,119,20,248,483,1200,15.5416666666667,0.443601895734597,0.224299065420561,0.468354430379747,0.779220779220779,6.25,FALSE,1,3
"Terrell Brandon",760,514,22762,4120,9227,406,1157,3714,8070,1849,2121,452,1856,2308,4716,1205,236,1493,1407,10495,29.95,0.446515660561396,0.350907519446845,0.460223048327138,0.871758604431872,13.8092105263158,FALSE,1,11
"Terry Dehere",428,65,7596,1113,2717,344,906,769,1811,748,961,151,461,612,1061,220,39,633,860,3318,17.7476635514019,0.409642988590357,0.379690949227373,0.424627277747101,0.778355879292404,7.75233644859813,FALSE,1,6
"Terry Porter",1274,732,35354,5428,11734,1297,3360,4131,8374,3433,4107,715,3157,3872,7160,1583,181,2666,2203,15586,27.7503924646782,0.462587352991307,0.386011904761905,0.493312634344399,0.835889943998052,12.2339089481947,FALSE,1,17
"Tierre Brown",134,1,1654,202,526,30,85,172,441,93,121,41,125,166,266,64,4,143,95,527,12.3432835820896,0.384030418250951,0.352941176470588,0.390022675736961,0.768595041322314,3.93283582089552,FALSE,1,4
"Tim Hardaway",1015,832,34761,6285,14688,1803,5078,4482,9610,2869,3665,593,2615,3208,8013,1617,156,2827,2337,17242,34.2472906403941,0.427900326797386,0.355061047656558,0.466389177939646,0.78281036834925,16.9871921182266,TRUE,1,13
"Tim Legler",343,4,5888,867,1946,282,668,585,1278,455,545,153,387,540,448,173,47,222,572,2471,17.1661807580175,0.445529290853032,0.422155688622754,0.457746478873239,0.834862385321101,7.20408163265306,FALSE,1,10
"Todd Day",562,209,14021,2335,5834,668,1948,1667,3886,1501,2014,648,1225,1873,820,613,342,826,1573,6839,24.9483985765125,0.400239972574563,0.342915811088296,0.428975810602162,0.745283018867924,12.1690391459075,FALSE,1,8
"Todd Lichti",250,51,4366,753,1646,21,80,732,1566,401,513,185,342,527,336,186,46,259,433,1928,17.464,0.457472660996355,0.2625,0.467432950191571,0.781676413255361,7.712,FALSE,1,5
"Tom Garrick",291,52,5267,602,1302,6,64,596,1238,286,372,135,422,557,951,302,26,387,501,1496,18.0996563573883,0.462365591397849,0.09375,0.481421647819063,0.768817204301075,5.14089347079038,FALSE,1,4
"Toney Douglas",516,82,9475,1354,3361,557,1574,797,1787,480,578,265,835,1100,1108,439,38,525,1001,3745,18.3624031007752,0.402856292770009,0.353875476493011,0.44599888080582,0.830449826989619,7.2577519379845,FALSE,1,8
"Tony Bennett",152,7,1886,221,536,55,164,166,372,41,56,28,127,155,303,69,1,93,200,538,12.4078947368421,0.412313432835821,0.335365853658537,0.446236559139785,0.732142857142857,3.53947368421053,FALSE,1,3
"Tony Delk",709,129,15215,2485,6140,601,1794,1884,4346,946,1233,459,1320,1779,1361,586,100,760,1084,6517,21.459802538787,0.404723127035831,0.335005574136009,0.433502070869765,0.767234387672344,9.19181946403385,FALSE,1,10
"Tony Dumas",180,14,2500,442,1109,106,340,336,769,236,387,97,117,214,211,75,21,164,301,1226,13.8888888888889,0.398557258791704,0.311764705882353,0.436931079323797,0.609819121447028,6.81111111111111,FALSE,1,4
"Tony Smith",516,90,8233,1133,2636,158,507,975,2129,378,553,354,476,830,1035,356,89,508,823,2802,15.9554263565891,0.429817905918058,0.31163708086785,0.457961484264913,0.683544303797468,5.43023255813953,FALSE,1,9
"Tony Wroten",145,34,3076,575,1393,84,363,491,1030,370,572,106,257,363,437,137,28,375,268,1604,21.2137931034483,0.412778176597272,0.231404958677686,0.476699029126214,0.646853146853147,11.0620689655172,FALSE,1,4
"Tracy Jackson",178,3,2275,358,774,2,13,356,761,172,228,158,148,306,159,92,17,132,231,890,12.7808988764045,0.462532299741602,0.153846153846154,0.467805519053876,0.754385964912281,5,FALSE,1,3
"Trajan Langdon",119,5,1738,220,529,86,217,134,312,121,133,29,130,159,152,56,14,98,179,647,14.6050420168067,0.415879017013232,0.3963133640553,0.429487179487179,0.909774436090226,5.43697478991597,FALSE,1,3
"Travis Best",782,169,16897,2230,5160,287,831,1943,4329,1210,1440,250,1150,1400,2768,750,67,1027,1789,5957,21.6074168797954,0.432170542635659,0.345367027677497,0.448833448833449,0.840277777777778,7.61764705882353,FALSE,1,10
"Travis Diener",188,21,2711,300,778,165,472,135,306,95,115,39,207,246,440,80,9,99,202,860,14.4202127659574,0.38560411311054,0.349576271186441,0.441176470588235,0.826086956521739,4.57446808510638,FALSE,1,5
"Travis Mays",115,64,2964,429,1047,104,287,325,760,311,415,75,158,233,326,102,14,213,232,1273,25.7739130434783,0.40974212034384,0.362369337979094,0.427631578947368,0.749397590361446,11.0695652173913,FALSE,1,3
"Trent Tucker",756,207,15671,2594,5632,575,1410,2019,4222,473,627,512,1008,1520,1532,679,88,593,1594,6236,20.728835978836,0.460582386363636,0.407801418439716,0.478209379441023,0.754385964912281,8.24867724867725,FALSE,1,11
"Trevor Ruffin",110,24,1870,347,845,142,383,205,462,175,220,29,126,155,317,57,4,196,184,1011,17,0.410650887573965,0.370757180156658,0.443722943722944,0.795454545454545,9.19090909090909,FALSE,1,2
"Troy Hudson",517,168,11280,1714,4278,452,1333,1262,2945,757,882,193,684,877,1748,273,30,818,690,4637,21.8181818181818,0.40065451145395,0.339084771192798,0.428522920203735,0.85827664399093,8.96905222437137,FALSE,1,11
"Ty Lawson",617,357,17499,2635,5778,509,1427,2126,4351,1571,2050,377,1249,1626,3553,689,59,1254,985,7350,28.3614262560778,0.456040152301835,0.356692361597758,0.488623304987359,0.766341463414634,11.9124797406807,FALSE,1,8
"Tyronn Lue",718,225,15828,2244,5108,581,1478,1663,3630,901,1084,161,1031,1192,2183,338,11,814,1345,5970,22.0445682451253,0.439310884886453,0.393098782138024,0.458126721763085,0.831180811808118,8.31476323119777,FALSE,1,11
"Tyus Edney",226,87,4743,583,1438,65,202,518,1236,497,617,122,271,393,910,217,6,395,387,1728,20.9867256637168,0.405424200278164,0.321782178217822,0.419093851132686,0.805510534846029,7.64601769911504,FALSE,1,4
"Vern Fleming",893,523,24721,3964,7954,38,210,3926,7744,2159,2826,979,2033,3012,4293,926,105,1795,2003,10125,27.6830907054871,0.498365602212723,0.180952380952381,0.506973140495868,0.763977353149328,11.3381858902576,FALSE,1,12
"Vernon Maxwell",1019,515,27592,4383,10986,1355,4259,3028,6727,1997,2749,446,2105,2551,3309,1096,169,1881,2049,12118,27.0775269872424,0.398962315674495,0.318149800422634,0.450126356473911,0.726445980356493,11.892051030422,FALSE,1,13
"Vincent Askew",583,31,11328,1448,3029,85,283,1363,2746,980,1305,487,948,1435,1229,361,131,618,1230,3961,19.4305317324185,0.478045559590624,0.300353356890459,0.496358339402768,0.75095785440613,6.79416809605489,FALSE,1,9
"Vinny Del Negro",836,371,20133,2969,6265,244,690,2725,5575,1110,1317,296,1596,1892,2610,602,68,854,1544,7292,24.0825358851675,0.47390263367917,0.353623188405797,0.488789237668161,0.842824601366743,8.72248803827751,FALSE,1,12
"Vonteego Cummings",199,23,3789,521,1359,109,340,412,1019,230,317,118,255,373,534,176,32,259,387,1381,19.0402010050251,0.383370125091979,0.320588235294118,0.404317958783121,0.725552050473186,6.93969849246231,FALSE,1,3
"Voshon Lenard",591,327,15807,2519,6083,961,2515,1558,3568,937,1202,352,1304,1656,1221,445,135,779,1251,6936,26.746192893401,0.414104882459313,0.382107355864811,0.436659192825112,0.779534109816972,11.7360406091371,FALSE,1,11
"Walker Russell",183,3,2124,212,551,10,51,202,500,114,147,58,155,213,408,75,11,234,224,548,11.6065573770492,0.38475499092559,0.196078431372549,0.404,0.775510204081633,2.99453551912568,FALSE,1,6
"Walter Bond",176,42,2717,368,889,56,178,312,711,188,247,88,233,321,201,103,38,163,407,980,15.4375,0.413948256467942,0.314606741573034,0.438818565400844,0.761133603238866,5.56818181818182,FALSE,1,3
"Wes Matthews",564,NA,11959,1909,3969,42,189,1867,3780,921,1166,225,567,792,2449,567,101,1264,1251,4781,21.2039007092199,0.480977576215671,0.222222222222222,0.493915343915344,0.789879931389365,8.47695035460993,FALSE,1,9
"Will Bynum",360,29,6611,1117,2529,84,309,1033,2220,603,755,125,436,561,1185,256,29,578,670,2921,18.3638888888889,0.441676551996837,0.271844660194175,0.465315315315315,0.798675496688742,8.11388888888889,FALSE,1,8
"Will Solomon",168,22,2296,323,821,102,334,221,487,99,141,36,160,196,358,89,15,170,218,847,13.6666666666667,0.393422655298417,0.305389221556886,0.453798767967146,0.702127659574468,5.04166666666667,FALSE,1,2
"William Avery",142,1,1205,137,415,40,157,97,258,65,91,17,76,93,199,34,6,106,125,379,8.48591549295775,0.330120481927711,0.254777070063694,0.375968992248062,0.714285714285714,2.66901408450704,FALSE,1,3
"Willie Green",731,297,14783,2417,5682,517,1494,1900,4188,708,925,242,1061,1303,1018,393,108,705,1259,6059,20.2229822161423,0.425378387891587,0.346050870147256,0.453677172874881,0.765405405405405,8.28864569083447,FALSE,1,12
"Winston Garland",590,334,15153,2142,5017,85,296,2057,4721,1004,1209,464,1183,1647,2724,752,90,1133,1403,5373,25.6830508474576,0.426948375523221,0.287162162162162,0.435712772717645,0.830438378825476,9.10677966101695,FALSE,1,7
"Zoran Planinić",148,10,1584,197,486,37,128,160,358,130,192,47,151,198,165,58,7,120,237,561,10.7027027027027,0.405349794238683,0.2890625,0.446927374301676,0.677083333333333,3.79054054054054,FALSE,1,3
